Hh, Hh, Hh^Fms, Hh, Gs^Fms, Gs^Fms, Gs^Fms, Gs^Fms, Gs, Gs, Gs, Gs, Gs, Gs, Gs, Gs, Gs, Gs, Gs, Gs, Gs, Gs, Gs, Gs, Gs, Gs, Gs, Gs, Gs, Gs, Gs, Gs, Gs, Gg, Gs, Gs, Gs, Gs, Ww, Ww, Gs, Gs, Gs, Gg^Fp, Gg^Fp, Gg^Fp, Gg^Fp
Hh^Fms, Hh, Gs, Gs^Em, Gd, Gd, Gs, Gs, Gs^Fms, Gs^Fms, Gs, Gs, Gs, Gs, Gs, Gs, Co, Gs, Co, Gs, Gs, Gs, Gs, Gs, Gs, Gs, Gs, Gs, Gs, Gs, Gs, Gs, Gs, Gs, Gs, Gs, Gs, Ww, Ss^Vhs, Gs, Gll^Fp, Gg, Gg, Gg^Fp, Gg^Fp, Gg^Fp, Gg^Fp
Hh, Hh^Em, Hh, Hh, Gd, Gs^Vo, Gs, Gs^Fms, Gs^Fms, Gs, Gs, Gs, Gs, Gs, Co, Co, Co, 2 Ko, Co, Co, Co, Gs, Gs, Gs, Gs, Gs, Gs^Edb, Gs, Gs, Gs, Gs, Gs, Gs, Gs, Gs, Gs, Hh, Ww, Ww, Gs, Gg^Fp, Gg, Gg^Fp, Gg^Efm, Gg^Fp, Gg^Efm, Gg^Fp
Hh, Hh, Re, Hh^Fms, Hh^Fms, Hh^Fms, Hh^Fms, Hh^Fms, Hh^Fms, Hh, Hh, Gs, Rp, Rp, Hh, Gd^Vo, Hh, Gs, Gs, Gs, Gs, Rp, Rp, Gs, Gs, Gs, Gs^Efm, Gs^Efm, Rp, Rp, Rp, Gs, Rp, Rp, Rp, Rp, Ww^Bw\, Ww, Rp, Cvr, Gg^Fp, Gg^Fp, Gg^Fp, Gg^Fp, Gg^Fp, Gg^Fp, Gg^Fp
Hh, Gs^Fms, Hh^Fms, Hh^Fms, Hh^Fms, Hh^Fms, Hh^Fms, Hh^Fms, Hh^Es, Gs^Edt, Gs, Hh, Hh, Rp, Rp, Hh, Hh, Gs, Gs^Edt, Gs, Gs, Gs, Ww^Bw|r, Rp, Rp, Rp, Rp, Rp, Gs, Gd^Vo, Gs, Rp, Hh, Hh, Hh, Hh, Ww, Rp, Hh^Fp, Re, Rp, Rp, Gg^Fp, Cv, 4 Kv, Cv, Gll^Fp
Hh^Fms, Re, Hh^Fds, Sm, Ss, Sm, Hh^Fp, Sm, Hh^Fms, Hh^Fms, Hh^Fms, Hh^Vhh, Hh^Fms, Rp, Rp, Rp, Hh, Hh, Hh^Es, Hh^Emf, Hh, Hh^Emf, Ss, Ww, Gs, Rp, Gs, Gs, Gs, Gs, Gs, Gs, Gs, Hh, Ss, Ww, Ss, Gs, Hh^Fp, Gg^Fp, Gll^Fp, Gg^Fp, Gg^Fp, Cv, Gg^Fp, Cv, Gll^Fp
Hh^Fms, Hh^Fms, Ss, Hh^Fms, Gs^Fms, Cte, Ss, Sm, Hh^Fms, Hh^Fms, Mm, Mm, Hh, Hh, Hh, Rp, Hh, Hh, Hh, Hh, Hh, Hh, Ss, Wwrg, Gs, Rp, Rp, Gs, Gs, Gd, Gs, Gs, Gs, Gs, Gg, Gd, Gd, Hh, Gg^Ve, Gg^Fp, Gg^Fp, Gg^Fp, Gg^Fp, Re, Re, Gg^Ve, Gg^Fp
Gs^Fms, Sm, Hh^Fms, Rb, Ss, Ss, Gd^Fetd, Hh, Wwg, Mm, Hh^Fms, Hh^Fms, Hh, Hh, Hh, Rp, Hh, Hh, Hh, Hh, Ww^Ewl, Wwrg, Sm, Gs, Gs, Rp, Rp, Gs, Rp, Gs^Efm, Rp, Gs, Gs, Hh, Hh^Fp, Gs, Gg, Gg^Fp, Gg^Fp, Gg^Fp, Gg^Fp, Gg^Fp, Gg^Fp, Gg^Fp, Re, Gg^Fp, Gg^Fp
Gs, Hh^Fms, Rb, Sm, Ss, Wwg, Gd, Wog, Wog, Rp, Hh^Fms, Hh^Fms, Rp, Rp, Rp, Rp, Hh, Hh, Hh, Hh, Wwrg, Wwg, Ss, Sm, Gs, Gs, Rp, Rp, Gs^Efm, Rp, Ds, Rp, Rp, Gs, Gs, Gg^Fp, Wwg, Gg, Gg, Gg^Fp, Gg, Gg^Fp, Gg^Fp, Gg^Fp, Gll^Fp, Gg^Fp, Gg^Fp
Gs^Fetd, Gs^Fms, Gs^Fms, Gs^Fms, Hh^Fms, Ss^Bw/r, Gd, Gd^Fms, Rp, Gs^Fms, Hh^Fp, Hh, Hh, Gs, Hh, Hh, Mm, Hh^Es, Hh, Chs, Ds, Ss^Vhs, Ss, Ss, Ds, Ds, Ww, Ds, Ds, Ww^Ewf, Gs, Rp, Gs, Gd^Vo, Gs, Gs, Gs, Gs, Gg^Fp, Gg, Gg^Fp, Gg^Fp, Re, Re, Hh^Fp, Gg^Fp, Gll^Fp
Gs^Fms, Rb, Gs^Em, Ss, Hh^Fms, Wwg, Wwg, Rp, Ww^Ewf, Hh^Fms, Hh, Hh, Hh, Hh, Gs, Hh, Mm, Mm, Hh, Sm, Ds, Ds, Ww, Ds, Ww, Ww, Ww, Ww, Ds, Ds, Rp, Rp, Gs, Gs, Wwg, Gs, Wwg, Wwg, Re, Re, Re, Gg^Fp, Hh^Fp, Hh^Fp, Gg^Fp, Gg^Fp, Gg^Fp
Gs^Fms, Rb, Gs^Fms, Gs, Rp, Ww^Ewl, Wwg^Bw/r, Rp, Re, Hh^Fms, Re, Cte, Re, Gs^Es, Gs, Gs, Mm, Mm, Gs, Ds, Ww, Ww, Wo, Ww, Wo, Wo, Ww, Ww, Ds, Ds, Hh, Rp, Hh, Gs, Sm, Gs, Gs, Rp, Gs, Gg^Fp, Gg^Fp, Gg^Fp, Gg^Fp, Gg^Fp, Hh^Fp, Gg^Fp, Gg^Fp
Gs, Gs^Vht, Gs^Fms, Re, Hh, Rp, Hh^Fms, Gs, Hh, Re, Hh^Fms, Re, Gs, Re, Re, Gd, Gd, Cte, Gd, Ds, Ww, Ww, Wo, Wo, Ww, Ww, Ww^Ewl, Ds, Ds, Ds, Gs, Hh, Hh, Hh, Gs, Sm, Gg, Rp, Gg, Gg^Fp, Gg^Fp, Gll^Fp, Gg^Fp, Gg^Fp, Gg^Fp, Gg^Fp, Gg^Fp
Gd, Gs^Fms, Re, Rr, Gs^Fms, Gs, Gs^Fms, Hh^Fms, Gs^Fms, Ds, Ds, Gs^Em, Hh, Gs, Hh, Re, Re, Gd, Gs, Ds, Ds, Ww, Wo, Wo, Ww, Ww, Ds, Ds, Gs, Gs, Hh, Rp, Rp, Gs, Sm, Gg, Gg, Rp, Hh^Fp, Gs, Gs, Gg^Fp, Hh^Fp, Gg^Fp, Hh^Fp, Gg^Fp, Gg^Fp
Gs, Rp, Gs^Fms, Gs^Fms, Gs^Fms, Gs^Fms, Gs^Fms, Hh^Fms, Ww, Ww, Ds, Gs^Edb, Gs^Fms, Hh, Hh, Hh, Gs, Re, Ds, Ds, Ww, Ww, Ww, Ww, Ds, Ww, Ds, Gd, Gs^Eff, Gd, Gd^Eff, Gd, Gd^Vo, Rp, Rp, Gs, Rp, Rp, Gs, Hh^Fp, Hh^Fp, Gg^Fp, Gg^Fp, Gg^Fp, Gg^Efm, Gg^Fp, Gg^Fp
Gs, Rp, Gs^Edt, Gs^Fms, Gd^Fms, Gs^Fms, Gs^Fms, Sm, Hh^Fms, Ww, Ww^Ewf, Ds, Ww, Ds, Gs, Gs, Gs^Es, Re, Ds, Ds, Ww, Ww, Ww, Ww, Ds, Ds, Gs^Eff, Gs^Eff, Rb^Gvs, Rb^Gvs, Rb^Gvs, Gd^Eff, Gs, Gd, Gd, Rp, Gs^Efm, Gs, Gs, Gg^Fp, Gs, Gg^Fp, Gg^Fp, Gg, Gg^Fp, Gg^Efm, Gg^Fp
Gs, Rp, Gs, Gs, Gs^Fms, Gd^Vo, Gs^Fms, Hh^Fms, Ds, Ww, Ww, Ww, Ww, Ds, Ds, Gs, Wwf, Re, Wwf, Ww, Ds, Ww, Ds, Ds, Gs, Gs, Rb^Gvs, Rb^Gvs, Rb^Gvs, Rb^Gvs, Gs, Gs, Cer, Chr, Gs, Rp, Gd, Gs, Gd, Gs, Gs, Gs, Gs, Gg^Fp, Gs, Gg, Gg^Fp
Gs, Rp, Gs, Gs, Gs, Gs^Fms, Gs^Fms, Hh^Fms, Ds, Ww, Ww, Ww, Ww, Ds, Ww, Ww, Ww, Wwf, Re, Ds, Gs, Ds, Gs, Gs, Re, Gs^Vl, Re, Rb^Gvs, Re, Gs, Re, Re, Re, Gs, Re, Rp, Gs, Gd, Gs^Es, Gs, Gs, Gs, Gs, Gll^Fp, Gll^Fp, Gs, Gg^Fp
Gs, Rp, Rp, Gs, Gs, Gs^Fms, Gs, Hh^Fms, Ww, Ww, Ww^Ewl, Ww, Ww, Ww, Ww, Ww, Ww, Wwf, Gs, Re, Re, Re, Re, Re, Gs^Es, Re, Gs, Re, Re, Re, Gs, Gs^Ecf, Gs, Re, Gs, Rp, Rp, Gs, Gs, Gs, Gd, Gs, Gs, Gll^Fp, Gs, Gs, Gs
Gs, Gs, Rp, Rp, Gs^Es, Gs^Es, Gs, Hh^Fms, Ww, Ww, Gs, Ww, Ww, Ww, Ww, Ww, Ww, Ww, Ww, Re, Ww, Ww, Ww, Gs, Gs^Em, Chs, Sm, Sm, Sm, Gs, Gs, Gs, Gs, Gs, Gs, Gs, Ww^Bw|r, Gs, Gs, Gd, Gd, Gd, Gd, Gd, Gs, Gs, Gs
Gs, Gs, Co, Co, Co, Gs, Gs, Ww, Ww, Gs, Re, Ww, Gs, Chr, Ww^Ewl, Ww, Ww, Ww, Wwrg, Wwf, Ww, Ww, Gs, Wwf, Ww, Sm, Ww, Sm, Gs, Gs, Gs, Gs, Ww, Gs, Gs, Ww, Gs, Ww, Ww, Gs, Gs, Gs, Gs, Gd, Gs, Gs, Ww
Gs, Gs, 1 Ko, Gs, Gs^Edt, Gs, Gs^Efm, Ww, Wwf, Re, Gs, Re, Re, Gs, Gs, Ww, Chw, Wwr, Ww^Vm, Wwf, Gs, Gs, Gs, Ww, Ww, Ww, Ww, Ww^Ewl, Ww, Gs, Gs, Gs, Ww, Ww, Ww, Ww, Ww^Bw|r, Ww, Ww, Ww, Ww, Ww^Ewl, Ww, Gs, Gs, Ww, Ww
Gs, Gs, Co, Gd^Vo, Co, Rp, Rp, Re, Ww, Ww, Ww, Gs, Gs^Efm, Re, Re, Re, Re, Ww^Bw/r, Ww, Ww, Ww, Wo, Gs^Es, Gs, Ww^Ewf, Ww, Ww, Ww, Ww, Ww, Ww, Ww, Ww, Ww, Ww, Ww, Rr, Chr, Gs, Gs, Gs, Ww, Ww, Gs, Ww, Ww, Ww^Ewf
Gs, Gs, Gs, Co, Gs, Gs, Gs, Rp, Rp, Ww, Ww, Ww, Ww, Ww, Ww, Gs, Ww, Re, Ww, Ww, Wo, Wo, Wo, Gs, Gs, Ww, Wo, Wo, Wo, Ww, Wo, Ww, Ww, Ww, Ww, Chr, Gs, Rr, Gs, Gs, Gs, Gs, Gs, Ww, Ww, Ww, Ww
Gs, Gs, Gs, Gs, Ww, Ww, Ww, Gs, Gs, Rp, Ww^Bw\r, Chr, Gs, Gs, Gs, Ww, Gd, Ww^Bw|r, Ww, Wo, Ww^Ewl, Ww, Ww, Wo, Wo, Wo, Wo, Gs^Edb, Gs, Wo, Ww^Ewl, Ww, Ww, Ww, Ww, Gs, Gs^Edt, Rr, Gs, Gs, Gs, Gs, Gs, Gs, Gs, Ww, Gs
Gs, Gs, Gs, Gs, Ww^Ewl, Ww, Gs, Ww, Ww, Ww, Chr, Rp, Rp, Gs, Gs^Es, Gd, Gd, Re, Ww, Ww, Ww, Ww, Gs, Ww, Ww, Wo, Ww, Ww, Ww, Gs^Es, Gs, Gs^Es, Ww, Ww, Gs, Gs, Gs, Rr, Gs, Gs, Rr, Rr, Rr, Gs, Gs, Gs, Gs
Ww, Ww, Ww^Ewl, Ww, Ww, Gs, Gs, Gs, Gs, Gs, Gs, Gs, Gs, Rp, Rp, Gs, Gs, Wwr, Chw, Chw, Gs, Wwr, Gs, Ww, Gs, Ww, Ww, Ww, Ww, Ww, Ww, Ww, Gs, Gs, Gd, Gd, Gs^Es, Rr, Rr, Rr, Gs, Gs, Gs, Rr, Rr, Rr, Rr
Gs, Gg, Gg, Ww, Gg, Gs, Gs, Gs, Gs, Gs, Gs, Gs, Gs, Gs, Gs, Rp, Rp, Rp, Rp, Rp, Rp, Gs, Gs, Gs, Gs, Gs, Gs, Gs, Gs, Gs, Ce, Gs, Ce, Gs, Gs, Gs^Vct, Rr, Rr, Gs, Rr, Gs, Gs, Gs, Gs, Gs^Esd, Gs^Efm, Gs
Mm, Gg, Ww, Ww, Hh, Hh, Hh, Gs, Hh, Hh, Hh, Gs, Gs, Gs, Gs, Gs^Edt, Gs, Rp, Gs, Gs, Gd, Rp, Rp, Rp, Rp, Gs^Efm, Rp, Gs, Rp, Gs^Vh, Ce, 3 Ke, Gs, Rp, Rp, Rr, Gs, Gs, Gs, Rr, Gs, Gs, Gs, Gs, Gs, Gs, Gs
Mm, Hh, Hh, Mm, Mm, Hh, Hh, Hh, Hh, Hh, Hh, Hh^Vhh, Hh, Hh, Hh, Hh, Hh^Edb, Hh, Hh, Hh, Hh^Vhh, Gd, Gd, Gd, Gd, Rp, Gs, Rp, Rp, Ce, Ce, Gs, Gs^Es, Gs, Gs, Gs^Esd, Gs, Gs, Gs, Rr, Rr, Gs, Gs, Gs, Gs, Gs, Gs
Mm, Mm, Mm, Mm, Mm, Hh, Mm, Hh, Mm, Hh, Mm, Hh, Mm, Mm, Mm, Hh, Hh, Hh, Hh, Gd, Gs, Gd, Gs, Gd, Gs, Gs, Gs, Gs, Gs, Gs, Gs, Gs, Gs, Gs, Gs, Gs, Gs, Gs, Gs, Gs, Rr, Gs, Gs, Gs, Gs, Gs, Gs
Mm, Mm, Mm, Mm, Mm, Mm, Mm, Mm, Mm, Mm, Mm, Mm, Gs, Mm, Mm, Mm, Hh, Hh, Gs, Gs, Gs, Gs, Gs, Gs, Gs, Gs, Gs, Gs, Gs, Gs, Gs, Gs, Gs, Gs, Gs, Gs, Gs, Gs, Gs, Gs, Rr, Gs, Gs, Gs, Gs, Gs, Gs
