Gll^Fp, Gll^Fp, Gll^Fmw, Gll^Fp, Gll^Fmw, Gll^Fp, Ss, Gs^Fds, Gll^Fmw, Ss, Gll^Qhuf, Gll^Fp, Gll^Qhuf, Gll^Qhuf, Ss^Qhu, Gll^Qhuf, Qxu^Qhu, Gll^Qhuf, Ss, Ww, Wwg, Gll^Fp, Wog, Ss, Wwg, Gll^Fp, Md^Xm, Mm, Mm, Mm, Mm^Xm, Mm^Xm, Ha, Gg, Mm, Mm, Ha^Qhh, Gg^Qhh, Ha^Qhh, Gg, Aa^Fpa, Aa^Fda, Wog^Qhu, Wog^Qhu, Aa^Fpa, Ha, Ha, Ha, Aa^Fma, Ms, Gg
Gll^Fp, Gs, Gll^Fmw, Gll^Qhh, Hh, Gll^Fmw, Gs, Rb, Rb, Gs, Gll^Qhuf, Gll^Qhuf, Gll^Qhuf, Ss^Qhu, Ss^Qhu, Wwg^Qhu, Qxu^Qhu, Gs^Qhuf, Sm, Rb, Gll^Fmw, Ss, Wog, Wog, Ss, Md^Xm, Wo, Md^Xm, Hh^Qhhf, Mm^Xm, Gg, Hh^Fp, Hh^Fp, Mm^Xm, Mm^Xm, Gll^Fp, Gg^Dr, Gll^Fp, Rb, Rb, Aa, Wog^Qhu, Ai, Gg, Cea, 1 Ke, Ai^Qhu, Aa^Fma, Aa, Ms, Gg
Gll^Fp, Gll^Fp, Ss, Rb^Qhh, Ss^Qhh, Gs^Qhh, Hh^Fp, Chs, Hh, Hh^Fp, Rb, Rb^Qhu, Gs^Qhuf, Ss^Qhu, Wog^Qhu, Qxu^Qhu, Chs, Wo, Wo, Qxe^Qhu, Qxu^Qhh, Wog, Ss, Sm, Ss, Gll^Fp, Wo, Mm^Qhh, Mm^Qhh, Mm^Xm, Mm, Mm^Xm, Ha^Qhh, Qxu, Mm^Qhh, Mm^Xm, Ha^Qhh, Aa^Qhh, Ha^Qhh, Aa, Aa^Fpa, Wog^Qhu, Hh, Gs, Aa, Ce^Qhu, Aa^Fpa, Hh^Fp, Aa, Aa^Voa, Ms
Gll^Fp, Gll^Fmw, Gs, Gll^Qhhf, Gs^Qhh, Gll^Qhhf, Gll^Qhhf, Rb, Rb, Gs, Hh, Gs^Qhu, Hh^Qhu, Hh^Qhu, Wog^Qhu, Gll^Fp, Wog, Wwg, Qxe^Qhu, Sm, Wog, Hh^Fp, Hh^Fp, Gll^Fmw, Ss, Qxu, Hh^Qhh, Hh^Fp, Mm^Xm, Mm^Xm, Qxu, Qxu, Mm^Qhh, Mm^Xm, Hh^Qhh, Rb^Qhh, Gg^Dr, Gll^Qhhf, Mm^Xm, Ms^Qhh, Mm^Qhh, Ai^Qhh, Gll^Fmw, Gll^Fmw, Gs, Hh^Fp, Ai^Qhu, Ha^Emf, Aa^Fpa, Ms, Ms
Gll^Fp, Gll^Qhhf, Gll^Qhhf, Gll^Qhhf, Gll^Qhhf, Gll^Qhhf, Gll^Fp, Ss, Gll^Fp, Hh^Fp, Hh, Ss, Gll^Fp, Hh^Fp, Gll^Fp, Wog, Wwg, Rb, Rb, Gs, Re, Chs, Hh, Gll^Fp, Gll^Fp, Hh^Qhhf, Hh^Qhh, Gll^Feth, Rb^Gvs, Rb^Gvs, Re^Qhh, Hh^Qhh, Rb^Qhh, Hh^Qhh, Ha^Qhh, Ms^Qhh, Gll^Qhhf, Wog, Hh^Fp, Hh^Qhh, Ha^Vhha, Ha^Qhh, Ha^Qhh, Gll^Fmw, Aa, Re^Emf, Aa^Fpa, Ai^Qhu, Gs^Fetd, Aa^Fpa, Ms
Wo, Gll^Qhhf, Gll^Qhhf, Gll^Qhhf, Gll^Qhhf, Gll^Fp, Gll^Fp, Gs, Hh, Hh, Gll^Fp, Gs, Hh, Gll^Fmw, Wo, Wog^Bw/r, Gll^Fp, Wog, Hh^Qhh, Re, Gll^Fp, Rb^Qhu, Mm, Rb^Qhu, Gll^Fp, Hh, Gd^Qhu, Hh^Qhu, Gs^Fds, Gs, Hh^Fp, Re^Qhh, Re^Qhh, Gs^Qhh, Hh^Qhuf, Aa^Qhh, Qxu^Qhu, Gg^Dr, Mm, Urc, Wwg, Wwrg, Ss, Rb, Hh^Fp, Hh^Fp, Aa^Fpa, Ms^Xm, Ha^Emf, Ms, Hh^Fp
Wo, Wo, Wo, Gll^Qhhf, Mm, Mm, Mm, Mm, Hh, Hh, Gs, Gs^Fds, Hh, Gll^Fmw, Ce^Qhh, Gs, Gs^Qhh, Hh^Qhh, Hh^Qhh, Mm^Xm, Mm^Xm, Hh, Re^Qhu, Re^Qhu, Gs^Qhu, Rb^Qhu, Re^Qhu, Gd^Qhu, Gd, Re, Ss, Hh^Qhhf, Ss^Qhu, Aa^Qhuf, Qxu^Qhu, Hh^Qhuf, Ss, Hh^Fp, Mm^Xm, Mm, Mm^Xm, Hh^Fp, Ss, Re^Vct, Ha^Qhh, Aa^Qhh, Ms^Qhh, Ms, Hh^Fp, Ms^Xm, Gg
Wo, Wo, Wwrg, Mm, Mm, Mm, Mm, Mm, Hh, Gll^Fdw, Hh^Fmw, Hh^Fp, Gll^Fmw, Ce, 4 Ke, Ce, Ss^Qhh, Re^Qhh, Mm^Qhh, Mm^Qhh, Hh^Fmw, Mm, Mm, Mm, Mm, Hh, Gs, Re, Gd, Chs, Hh, Hh^Ebn, Qxu, Qxu, Qxu, Qxu, Qxu, Mm^Xm, Mm, Mm^Xm, Hh^Fp, Aa, Ai, Rb, Ha^Qhh, Aa^Qhh, Ai, Rb, Aa, Hh^Fp, Hh^Fp
Wog, Wo, Wo, Mm, Wwg^Ewl, Mm, Mm, Mm, Sm^Emf, Gll^Fdw, Gll^Fdw, Hh^Fp, Gll^Fmw, Ce, Wwg^Qhh, Gd^Qhh, Re^Qhh, Hh^Qhhf, Mm^Qhh, Mm^Xm, Hh^Fp, Mm, Mm, Mm^Xm, Hh^Fp, Gs, Re, Re^Es, Gs^Em, Gd, Hh^Fmw, Mm, Hh^Em, Hh^Em, Hh^Fmw, Mm^Xm, Ha^Fetd, Qxu, Ss, Hh, Hh^Fp, Mm^Xm, Hh^Fp, Ha^Qhh, Wwg, Hh^Qhh, Ai, Wwg, Ss, Gg, Hh^Fp
Wog, Wo, Wo, Wo, Wog, Mm, Mm, Hh, Sm^Em, Sm^Em, Gll^Fmw, Re^Vct, Ss, Chs, Hh^Qhh, Ss^Qhh, Re^Qhh, Hh^Qhh, Hh^Fp, Mm^Xm, Hh, Gll^Fp, Hh^Fmw, Gll^Fdw, Gd, Wwg, Gd, Gd, Hh^Fmw, Cer, Aa^Fpa, Hh^Fetd, Hh^Fds, Re, Re^Fetd, Mm, Hh^Fds, Ha, Ss, Mm, Mm^Xm, Mm^Xm, Ds^Qhu, Mm^Qhh, Hh^Qhh, Khw^Qhh, Ss, Gd, Hh^Fp, Hh^Fp, Gg
Wog, Wog, Wo, Wog, Wog, Mm, Hh, Mm, Sm^Em, Ss^Edb, Ss^Em, Ss, Re^Edb, Ss, Re^Qhu, Hh^Qhh, Re^Es, Gll^Fdw, Qxu, Sm, Gll^Fp, Wwg, Ww^Ewl, Wwg, Wwf, Wwg, Wwf, Ww^Ewf, Gs^Em, Re^Em, Gs^Qhu, Gd^Qhu, Gs^Fds, Re^Em, Ss, Ai, Gs^Fds, Mm, Ss, Ss, Mm, Mm, Mm, Ss^Qhu, Ss^Qhu, Gll^Fmw, Hh, Ai, Gs^Edt, Ss, Gg^Qhu
Mm, Wo, Wo, Wo, Wog, Mm, Mm, Ss^Emf, Ss^Em, Rb, Sm^Edb, Gll^Fmw, Sm, Gd^Es, Gd^Edpp, Gd^Edb, Gll^Fmw, Qxu, Gll^Feth, Hh^Fp, Gll^Fp, Wwf, Wwf, Chw, Ss, Wwg^Ewl, Wwf, Wwf, Hh^Fmw, Gs^Fp, Hh^Fp, Gs, Wwg, Gs^Fms, Gs, Wog, Gs^Efm, Gs^Fms, Gs, Hh^Qhhf, Ss^Vhs, Hh^Qhhf, Gll^Fmw, Hh^Fp, Hh^Fp, Gll^Fp, Gll^Fmw, Gd, Ds^Qhu, Ds^Qhu, Wwg^Qhu
Mm, Wwrg, Wwrg, Wog, Wog, Wwg^Ewl, Sm, Sm^Em, Wwg, Ss, Wwg^Edb, Sm, Wo, Wwg^Edb, Wwg, Wwr, Wwg, Wwf, Cer, Cer, Wwrt, Wwg, Wo, Ss, Wo, Wwf, Wwg, Wwg, Ss, Gs^Em, Gd, Gs, Wwg, Wwg, Wwg, Ss, Ss, Gs, Hh^Fp, Hh^Qhhf, Hh^Qhhf, Hh^Qhhf, Ss, Hh^Fp, Gs^Edt, Hh^Fp, Re, Gd, Gs^Qhu, Wwg^Qhu, Wwrg^Qhu
Mm, Mm, Wog, Wog, Wog, Wog, Wog, Wog, Wog, Wwrg, Wwg, Wo, Wo, Wo, Wo, Ww^Ewl, Wwg^Edb, Chs, Wo, Wo, Wo, Wo, Wo, Wo, Ww^Ewf, Wo, Wwrg, Re, Wot, Gg^Efm, Wwg^Ewf, Hh^Fp, Wwg^Ewl, Wo, Wo, Wwg, Gs, Gll^Fp, Gll^Fp, Gd, Wwg, Ww^Ewf, Hh^Fp, Ss, Gs, Gd, Hh, Hh, Gll^Qhhf, Wwg^Qhu, Wwg^Qhu
Mm, Mm, Mm, Wwg^Es, Wog, Wog, Wog, Wog, Wog, Wog, Wo, Wo, Wo, Wo, Wo, Wo, Wo, Wo, Wo, Wo, Wo, Wo, Wo, Wwg, Wwrg, Wwrg, Wwf, Wwf, Wwrg, Wwg^Ewl, Ww^Ewf, Wwg, Wo, Wo, Wo, Wwg, Wwg, Wwg, Ww^Ewl, Wwg, Gs^Vc, Hh^Fp, Hh^Fp, Cer, Wwg, Hh, Gs, Gll^Qhhf, Gll^Qhhf, Wwg^Qhu, Wo
Mm, Mm, Hh, Wwg^Ewl, Wwg^Ewl, Wog, Wwg, Wog, Wog, Wo, Wo, Wo, Wo, Wo, Wo, Wo, Wo, Wo, Wo, Wo, Wo, Wo, Wwf, Wwrg, Wwf, Wwf, Ww^Ewl, Wwf, Ww^Ewf, Ww^Ewf, Wo, Wo, Wo, Wo, Wo, Wo, Wo, Wo, Wwg, Gs^Edp, Wwg, Wwg, Wwf, Hh^Fp, Wwg, Hh^Fp, Wwg, Gll^Qhhf, Ww^Ewl, Wwg, Wo
Mm, Mm, Hh^Fmw, Hh, Re^Es, Wwg^Bw/, Wwg, Wog, Wo, Wo, Wo, Wo, Wwg, Wo, Wo, Wo, Wwg, Wo, Wwg, Wo, Chw, Wo, Wwg, Wwg, Wwg, Wwf, Wwg, Wwg, Wo, Wo, Wo, Wo, Wo, Wo, Wo, Wo, Wwrg, Wwf, Wo, Wwg, Wwg, Ww^Ewl, Wo, Wo, Wwrg, Wwg^Bw|r, Gs^Fds, Gs^Fds, Wwg, Wwg, Wo
Mm, Hh^Fp, Hh^Em, Gs^Fdw, Re^Gvs, Re^Wm, Wwrg, Wwg, Wwg, Wwrg, Wwg, Wwrg, Gs^Efm, Wwg, Re, Wo, Wwrg, Wwg, Chw, Wwg, Wwrg, Wwf, Wwg, Wwg, Wwf, Wwg, Wwg, Ww^Ewf, Wwg, Wwg, Wwg, Wwrg, Re^Es, Wwrg, Gg, Wwrg, Wwg, Wwrg, Wwf, Wwf, Wwf, Gs^Fds, Gs^Fds, Wo, Gs^Fds, Ww^Ewf, Ww^Ewl, Gs^Fds, Wwg, Wo, Wo
Hh^Fmw, Hh^Fmw, Gs^Fdw, Gs^Es, Re^Gvs, Wwf, Ww^Ewl, Wwrg, Wwg^Ewl, Wwg^Ewf, Wwg, Re^Es, Gs^Fds, Re^Gvs, Re^Gvs, Wwrg, Gg, Wwrg^Bw/r, Wo, Ww^Ewf, Rb, Wo, Wo, Wwg, Wwrg, Wwg, Wwf, Wwg, Gg, Wwf, Ch, Wo^Bw/, Wo^Qhu, Gs^Vh, Gg, Ww^Ewl, Wwrg, Wwf, Wo, Ww^Ewf, Wo, Wo, Wo, Chw, Wwg, Chw, Wo, Wwg, Wo, Wo, Wo
Hh^Em, Gs^Fmw, Gs^Qhh, Re^Gvs, Re^Gvs, Re^Gvs, Ss, Ss, Gs, Wwg^Ewf, Gs^Fds, Wwg^Ewl, Gs^Fds, Re^Gvs, Re^Vc, Gs^Es, Wwg^Ewl, Wwg^Ewl, Wo, Wwg, Wwg, Wwg, Ww^Ewl, Ww^Ewl, Ce, Wwrg, Wwg^Bw/, Gg, Re^Es, Re, Wwg^Qhu, Wwg^Qhu, Wwg^Qhu, Wwg^Qhu, Rb, Rb, Gg, Wwg, Wwg, Wwg, Wwrg, Chw, Wo, Wo, Wo, Wwg, Wo, Wo, Wo, Wo, Wo
Hh^Fp, Hh, Gg^Efm, Re^Es, Gs^Qhh, Gs^Qhh, Rp, Chr, Re^Es, Gg^Efm, Gs, Gs^Fds, Gg^Fet, Gll^Fmw, Hh, Gs, Gd, Gs, Gd, Wwg^Ewl, Gg^Fet, Ww^Ewl, Gd, Re, Re, Gs, Re^Es, Re^Es, Re, Gd, Re, Gs^Efm, Rr^Edb, Gg^Efm, Gg^Qhu, Gg^Qhu, Gs^Qhhf, Gg, Gg, Wwg, Wwg, Wo, Wo, Wo, Wo, Wo, Wo, Wo, Wo, Wo, Wo
Gs^Fmw, Gs^Fp, Gs^Fp, Re, Wwg, Rr, Rr^Vhc, Rp, Gd, Re^Dr, Re^Es, Gd, Gs^Fds, Mm, Gll^Fmw, Gs^Fds, Gd, Gs^Fp, Gd, Gd^Es, Re, Gd, Gs, Gll^Fmw, Re^Es, Re, Re, Rr, Rr, Re, Rr^Qhh, Re^Qhh, Gs^Qhh, Gs^Qhhf, Gs^Qhhf, Gg^Qhu, Gll^Qhhf, Gs^Qhhf, Gg, Gg, Gg, Wwg, Wo, Wo, Wo, Wo, Wo, Wo, Wo, Wo, Wo
Gs^Fdw, Gs^Fp, Ww^Ewf, Gg^Fet, Ww^Ewf, Re, Rr^Es, Rp, Gd, Gd, Gg, Ch, Re^Dr, Gll^Fmw, Re^Qhu, Re^Es, Re, Gd, Rr, Re, Re, Gd^Es, Re^Es, Gs^Efm, Rr, Re, Gs^Vh, Re, Re^Qhh, Gg^Qhhf, Gg^Qhh, Gs^Qhhf, Gs^Qhhf, Gs^Qhhf, Gs^Qhhf, Gg^Qhu, Gg^Qhu, Gll^Qhhf, Gll^Qhhf, Gs^Vl, Gg, Wwg, Wwg, Wwg, Wwg, Wwrg, Wo, Wo, Wo, Wo, Wo
Gs^Em, Gs^Fdw, Ww, Ww^Bw\, Gg, Rr, Rr^Dr, Gs^Efm, Gg, Chr, Ch, Gg, Ch^Qhu, Re^Qhu, Gg^Qhu, Gs^Vc, Gs, Rr, Gd, Re, Re^Eff, Re^Eff, Re^Eff, Re^Eff, Gd^Eff, Gd, Gs, Gg^Es, Re^Es, Gs^Efm, Gs^Qhhf, Gs^Qhhf, Gs^Qhhf, Gs^Qhhf, Gg^Bw/r, Gll^Qhhf, Gll^Qhhf, Gll^Qhhf, Re, Re, Gll^Fp, Gg, Gg, Gg, Wwrg, Wwrg, Wwrg, Wo, Wo, Wo, Wo
Gs, Re^Wm, Ce, Re, Re^Es, Gg^Efm, Ch, Gg^Em, Re, Rb^Dr, Ch, Ch^Qhu, Re^Dr, Gs^Qhu, Gs^Qhuf, Ce, Gs^Fms, Gd^Fmw, Rb^Eff, Re^Eff, Rb^Es, Re, Re^Gvs, Gd^Gvs, Gd^Gvs, Gd^Eff, Re^Eff, Gs, Gs^Fmw, Re^Qhh, Re^Qhh, Gll^Qhhf, Re^Es, Gll^Qhhf, Gll^Qhhf, Re, Gg, Rb, Re, Gll^Fp, Gll^Fp, Gs^Fds, Gll^Fp, Gg, Gg, Wwg, Wwg, Wwg, Wwg, Wo, Wo
Ce, Ce, Re^Gvs, Ce^Qhh, Ch^Qhh, Ch^Qhh, Re, Ch, Re^Es, 3 Kh, Gg^Qhu, Gg^Qhu, Rr^Vhc, Gs^Es, Gs^Fmw, Gs^Qhuf, Gs^Fmw, Re^Eff, Rb^Eff, Rb^Es, Rb, Re^Es, Re^Gvs, Re^Gvs, Re^Gvs, Re^Gvs, Gd^Gvs, Re^Eff, Re, Re^Qhh, Rb^Gvs, Re^Qhh, Gll^Fp, Re^Es, Gs^Vh, Gll^Qhhf, Gs^Fds, Gg, Gll^Fp, Re, Re, Rb, Re, Gg, Gg, Gg, Gs^Fds, Wwg, Wwrg, Wo, Wo
Re^Gvs, Re^Gvs, Re^Gvs, Re, Re^Eff, Rr^Qhh, Gs^Vc, Ch, Gs^Em, Re, Gg, Rp, Chr^Qhh, Gs^Em, Gs^Em, Gs^Qhuf, Mm, Re^Eff, Re^Gvs, Rb^Vh, Re^Es, Re^Gvs, Re^Wm, Re^Gvs, Re^Gvs, Re^Gvs, Gd^Es, Gs^Vc, Re^Es, Re^Gvs, Gg^Fmw, Gs^Fp, Gs^Em, Gs, Gs^Es, Gs^Es, Gs^Wm, Gll^Fp, Gg, Gll^Fp, Gg, Gll^Fp, Gg, Re, Gll^Fp, Gs^Fds, Gg, Ww^Ewl, Wwrg, Wo, Wo
Re^Gvs, Re^Gvs, Re^Gvs, Re^Gvs, Re^Eff, Re^Eff, Gs^Fp, Ch, Gs^Fmw, Re, Rr^Es, Re^Es, Re^Em, Gs^Qhhf, Gs^Qhhf, Gs, Gd, Gd^Gvs, Re^Gvs, Rb^Gvs, Re^Gvs, Re^Gvs, Re^Gvs, Re^Gvs, Re^Gvs, Gd, Gd^Es, Gd, Gs^Es, Gs^Eff, Gs^Eff, Gll^Fp, Gll^Emf, Gll^Fp, Gll^Fp, Gs^Emf, Gg, Gg, Gs^Fds, Gg, Gll^Fp, Gll^Fp, Gg, Rb, Gg, Gg, Gg, Gg, Gg, Ww^Ewf, Gg
Gg, Gs, Gs, Re^Eff, Gs^Fmw, Gs^Fmw, Gs^Fp, Ch, Gs^Fms, Gs^Fp, Re, Gs, Gs^Qhuf, Gs^Qhuf, Gs^Qhuf, Gs, Gs, Gd^Gvs, Re^Gvs, Re^Gvs, Re^Gvs, Re^Gvs, Re^Gvs, Re^Gvs, Re^Gvs, Gd, Re^Gvs, Gd, Gs, Gs^Eff, Gll^Fp, Gll^Fp, Gll^Fp, Gll^Fp, Gg, Gg, Gg, Gg, Gg, Gg, Gg, Gg, Gg, Gs^Fds, Gg, Gg, Gg, Gg, Gg, Gg, Wo
