Gll^Fp, Gll^Fp, Gll^Fmw, Gll^Fp, Gll^Fmw, Gll^Fp, Ss, Gs^Fds, Gll^Fmw, Ss, Gll^Fp, Gll^Fp, Gll^Fp, Gll^Fp, Ss, Gll^Fp, Qxu, Gll^Fp, Ss, Ww, Wwg, Gll^Fp, Wog, Ss, Wwg, Gll^Fp, Md^Xm, Mm, Mm, Mm, Mm^Xm, Mm^Xm, Ha, Gg, Mm, Mm, Ha, Gg, Ha, Gg, Aa^Fpa, Aa^Fda, Re, Gg, Aa^Fpa, Ha, Ha, Ha, Aa^Fma, Ms, Gg
Gll^Fp, Gs, Gll^Fmw, Gll^Fmw, Hh, Gll^Fmw, Gs, Rb, Rb, Gs, Gll^Fp, Gll^Fp, Gll^Fp, Ss, Ss, Wwg, Qxu, Gs^Fms, Sm, Rb, Gll^Fmw, Ss, Wog, Wog, Ss, Md^Xm, Wo, Md^Xm, Hh^Fp, Mm^Xm, Gg, Hh^Fp, Hh^Fp, Mm^Xm, Mm^Xm, Gll^Fp, Gg^Dr, Gll^Fp, Ha, Aa, Re, Rb, Ce, 1 Kea, Cea, Aa^Fpa, Re, Aa^Fma, Aa, Ms, Gg
Gll^Fp, Gll^Fp, Ss, Rb, Ss, Gs, Hh^Fp, Chs, Hh, Hh^Fp, Rb, Rb, Gs^Fms, Ss, Wog, Qxu, Chs, Wo, Wo, Qxe, Qxu, Wog, Ss, Sm, Ss, Gll^Fp, Wo, Mm, Mm, Mm^Xm, Mm, Mm^Xm, Ha, Qxu, Mm, Mm^Xm, Ha, Mm, Hh, Re, Aa^Fpa, Gs, Re, Gs, Aa, Re, Aa^Fpa, Hh^Fp, Gs, Aa^Voa, Ms
Gll^Fp, Gll^Fmw, Gs, Gll^Fp, Gs, Gll^Fp, Gll^Fp, Rb, Rb, Gs, Hh, Gs^Efm, Hh, Hh, Wog, Gll^Fp, Wog, Wwg, Qxe, Sm, Wog, Hh^Fp, Hh^Fp, Gll^Fmw, Ss, Qxu, Hh, Hh^Fp, Mm^Xm, Mm^Xm, Qxu, Qxu, Mm^Xm, Mm^Xm, Mm, Gll^Fp, Gg^Dr, Gll^Fp, Gll^Fp, Ha, Ha^Vhha, Gd, Gll^Fmw, Gll^Fmw, Gs, Hh^Fp, Ai, Ha^Emf, Aa^Fpa, Ms, Ms
Gll^Fp, Gll^Fp, Gll^Fmw, Gll^Fp, Gll^Fp, Gll^Fp, Gll^Fp, Ss, Gll^Fp, Hh^Fp, Hh, Ss, Gll^Fp, Hh^Fp, Gll^Fp, Wog, Wwg, Rb, Rb, Gs, Re, Chs, Hh, Gll^Fp, Gll^Fp, Hh^Fp, Hh, Gll^Feth, Rb^Gvs, Rb^Gvs, Re, Hh^Fp, Hh^Fp, Hh^Fp, Hh, Hh, Mm, Gs, Hh^Fp, Ha, Ha, Ha, Ha, Gll^Fmw, Aa, Re^Emf, Aa^Fpa, Ai, Gs^Fetd, Aa^Fpa, Ms
Wo, Gll^Fp, Gll^Fp, Gll^Fp, Gll^Fp, Gll^Fp, Gll^Fp, Gs, Hh, Hh, Gll^Fp, Gs, Hh, Gll^Fmw, Wo, Wog^Bw/r, Gll^Fp, Wog, Hh, Re, Gll^Fp, Rb, Mm, Rb, Gll^Fp, Hh, Gd^Edt, Hh, Gs^Fds, Gs, Hh^Fp, Re, Re, Gs, Hh^Fp, Gs, Gd, Ha, Mm, Wwg, Wwg, Re, Ss, Rb, Hh^Fp, Hh^Fp, Aa^Fpa, Ms^Xm, Ha^Emf, Ms, Hh^Fp
Wo, Wo, Wo, Gll^Fp, Mm, Mm, Mm, Mm, Hh, Hh, Gs, Gs^Fds, Hh, Gll^Fmw, Ce, Gs, Gs, Hh, Hh, Mm^Xm, Mm^Xm, Hh, Re, Re, Gs, Rb, Re, Gd, Gd, Re, Ss, Hh^Fp, Ss, Aa^Fpa, Qxu, Hh^Fp, Ss, Hh^Fp, Mm^Xm, Mm, Mm^Xm, Hh^Fp, Ss, Re^Vct, Ha, Aa, Ms, Ms, Hh^Fp, Ms^Xm, Gg
Wo, Wo, Wwrg, Mm, Mm, Mm, Mm, Mm, Hh, Gll^Fdw, Hh^Fmw, Hh^Fp, Gll^Fmw, Ce, 4 Ke, Ce, Ss, Re, Mm, Mm, Hh^Fmw, Mm, Mm, Mm, Mm, Hh, Gs, Re, Gd, Chs, Hh, Hh^Ebn, Qxu, Qxu, Qxu, Qxu, Qxu, Mm^Xm, Mm, Mm^Xm, Hh^Fp, Aa, Ai, Rb, Ha, Aa, Ai, Rb, Aa, Hh^Fp, Hh^Fp
Wog, Wo, Wo, Mm, Wwg^Ewl, Mm, Mm, Mm, Sm^Emf, Gll^Fdw, Gll^Fdw, Hh^Fp, Gll^Fmw, Ce, Wwg, Gd^Edpp, Re, Hh^Fmw, Mm, Mm^Xm, Hh^Fp, Mm, Mm, Mm^Xm, Hh^Fp, Gs, Re, Re^Es, Gs^Em, Gd, Hh^Fmw, Mm, Hh^Em, Hh^Em, Hh^Fmw, Mm^Xm, Ha^Fetd, Qxu, Ss, Hh, Hh^Fp, Mm^Xm, Hh^Fp, Ha, Wwg, Hh^Fp, Ai, Wwg, Ss, Gg, Hh^Fp
Wog, Wo, Wo, Wo, Wog, Mm, Mm, Hh, Sm^Em, Sm^Em, Gll^Fmw, Re^Vct, Ss, Chs, Hh, Ss, Re^Edb, Hh, Hh^Fp, Mm^Xm, Hh, Gll^Fp, Hh^Fmw, Gll^Fdw, Gd, Wwg, Gd, Gd, Hh^Fmw, Cer, Aa^Fpa, Hh^Fetd, Hh^Fds, Re, Re^Fetd, Mm, Hh^Fds, Ha, Ss, Mm, Mm^Xm, Mm^Xm, Ds, Mm, Hh^Fp, Khw, Ss, Gd, Hh^Fp, Hh^Fp, Gg
Wog, Wog, Wo, Wog, Wog, Mm, Hh, Mm, Sm^Em, Ss^Edb, Ss^Em, Ss, Re^Edb, Ss, Re, Hh, Re^Es, Gll^Fdw, Qxu, Sm, Gll^Fp, Wwg, Ww^Ewl, Wwg, Wwf, Wwg, Wwf, Ww^Ewf, Gs^Em, Re^Em, Gs, Gd, Gs^Fds, Re^Em, Ss, Ai, Gs^Fds, Mm, Ss, Ss, Mm, Mm, Mm, Ss, Ss, Gll^Fmw, Hh, Ai, Gs^Edt, Ss, Gg
Mm, Wo, Wo, Wo, Wog, Mm, Mm, Ss^Emf, Ss^Em, Rb, Sm^Edb, Gll^Fmw, Sm, Gd^Es, Gd^Edpp, Gd^Edb, Gll^Fmw, Qxu, Gll^Feth, Hh^Fp, Gll^Fp, Wwf, Wwf, Chw, Ss, Wwg^Ewl, Wwf, Wwf, Hh^Fmw, Gs^Fp, Hh^Fp, Gs, Wwg, Gs^Fms, Gs, Wog, Gs^Efm, Gs^Fms, Gs, Hh^Fp, Ss^Vhs, Hh^Fp, Gll^Fmw, Hh^Fp, Hh^Fp, Gll^Fp, Gll^Fmw, Gd, Ds, Ds, Wwg
Mm, Wwrg, Wwrg, Wog, Wog, Wwg^Ewl, Sm, Sm^Em, Wwg, Ss, Wwg^Edb, Sm, Wo, Wwg^Edb, Wwg, Wwr, Wwg, Wwf, Cer, Cer, Wwrt, Wwg, Wo, Ss, Wo, Wwf, Wwg, Wwg, Ss, Gs^Em, Gd, Gs, Wwg, Wwg, Wwg, Ss, Ss, Gs, Hh^Fp, Hh^Fp, Hh^Fp, Hh^Fp, Ss, Hh^Fp, Gs^Edt, Hh^Fp, Re, Gd, Gs, Wwg, Wwrg
Mm, Mm, Wog, Wog, Wog, Wog, Wog, Wog, Wog, Wwrg, Wwg, Wo, Wo, Wo, Wo, Ww^Ewl, Wwg^Edb, Chs, Wo, Wo, Wo, Wo, Wo, Wo, Ww^Ewf, Wo, Wwrg, Re, Wot, Gg^Efm, Wwg^Ewf, Hh^Fp, Wwg^Ewl, Wo, Wo, Wwg, Gs, Gll^Fp, Gll^Fp, Gd, Wwg, Ww^Ewf, Hh^Fp, Ss, Gs, Gd, Hh, Hh, Gll^Fp, Wwg, Wwg
Mm, Mm, Mm, Wwg^Es, Wog, Wog, Wog, Wog, Wog, Wog, Wo, Wo, Wo, Wo, Wo, Wo, Wo, Wo, Wo, Wo, Wo, Wo, Wo, Wwg, Wwrg, Wwrg, Wwf, Wwf, Wwrg, Wwg^Ewl, Ww^Ewf, Wwg, Wo, Wo, Wo, Wwg, Wwg, Wwg, Ww^Ewl, Wwg, Gs^Vc, Hh^Fp, Hh^Fp, Cer, Wwg, Hh, Gs, Gll^Fp, Gll^Fp, Wwg, Wo
Mm, Mm, Hh, Wwg^Ewl, Wwg^Ewl, Wog, Wwg, Wog, Wog, Wo, Wo, Wo, Wo, Wo, Wo, Wo, Wo, Wo, Wo, Wo, Wo, Wo, Wwf, Wwrg, Wwf, Wwf, Ww^Ewl, Wwf, Ww^Ewf, Ww^Ewf, Wo, Wo, Wo, Wo, Wo, Wo, Wo, Wo, Wwg, Gs^Edp, Wwg, Wwg, Wwf, Hh^Fp, Wwg, Hh^Fp, Wwg, Gll^Fp, Ww^Ewl, Wwg, Wo
Mm, Mm, Hh^Fmw, Hh, Re^Es, Wwg^Bw/, Wwg, Wog, Wo, Wo, Wo, Wo, Wwg, Wo, Wo, Wo, Wwg, Wo, Wwg, Wo, Chw, Wo, Wwg, Wwg, Wwg, Wwf, Wwg, Wwg, Wo, Wo, Wo, Wo, Wo, Wo, Wo, Wo, Wwrg, Wwf, Wo, Wwg, Wwg, Ww^Ewl, Wo, Wo, Wwrg, Wwg^Bw|r, Gs^Fds, Gs^Fds, Wwg, Wwg, Wo
Mm, Hh^Fp, Hh^Em, Gs^Fdw, Re^Gvs, Re^Wm, Wwrg, Wwg, Wwg, Wwrg, Wwg, Wwrg, Gs^Efm, Wwg, Re, Wo, Wwrg, Wwg, Chw, Wwg, Wwrg, Wwf, Wwg, Wwg, Wwf, Wwg, Wwg, Ww^Ewf, Wwg, Wwg, Wwg, Wwrg, Re^Es, Wwrg, Gg, Wwrg, Wwg, Wwrg, Wwf, Wwf, Wwf, Gs^Fds, Gs^Fds, Wo, Gs^Fds, Ww^Ewf, Ww^Ewl, Gs^Fds, Wwg, Wo, Wo
Hh^Fmw, Hh^Fmw, Gs^Fdw, Gs^Es, Re^Gvs, Wwf, Ww^Ewl, Wwrg, Wwg^Ewl, Wwg^Ewf, Wwg, Re^Es, Gs^Fds, Re^Gvs, Re^Gvs, Wwrg, Gg, Wwrg^Bw/r, Wo, Ww^Ewf, Rb, Wo, Wo, Wwg, Wwrg, Wwg, Wwf, Wwg, Gg, Wwf, Ch, Wo^Bw/, Wo, Gs^Vh, Gg, Ww^Ewl, Wwrg, Wwf, Wo, Ww^Ewf, Wo, Wo, Wo, Chw, Wwg, Chw, Wo, Wwg, Wo, Wo, Wo
Hh^Em, Gs^Fmw, Gs, Re^Gvs, Re^Gvs, Re^Gvs, Ss, Ss, Gs, Wwg^Ewf, Gs^Fds, Wwg^Ewl, Gs^Fds, Re^Gvs, Re^Vc, Gs^Es, Wwg^Ewl, Wwg^Ewl, Wo, Wwg, Wwg, Wwg, Ww^Ewl, Ww^Ewl, Ce, Wwrg, Wwg^Bw/, Gg, Re^Es, Re, Wwg, Wwg, Wwg^Ewl, Wwg, Rb, Rb, Gg, Wwg, Wwg, Wwg, Wwrg, Chw, Wo, Wo, Wo, Wwg, Wo, Wo, Wo, Wo, Wo
Hh^Fp, Hh, Gg^Efm, Re^Es, Gs, Gs, Rp, Chr, Re^Es, Gg^Efm, Gs, Gs^Fds, Gg^Fet, Gll^Fmw, Hh, Gs, Gd, Gs, Gd, Wwg^Ewl, Gg^Fet, Ww^Ewl, Gd, Re, Re, Gs, Re^Es, Re^Es, Re, Gd, Re, Gs^Efm, Rr^Edb, Gg^Efm, Gg, Gg, Gs^Fds, Gg, Gg, Wwg, Wwg, Wo, Wo, Wo, Wo, Wo, Wo, Wo, Wo, Wo, Wo
Gs^Fmw, Gs^Fp, Gs^Fp, Re, Wwg, Rr, Rr^Vhc, Rp, Gd, Re^Dr, Re^Es, Gd, Gs^Fds, Mm, Gll^Fmw, Gs^Fds, Gd, Gs^Fp, Gd, Gd^Es, Re, Gd, Gs, Gll^Fmw, Re^Es, Re, Re, Rr, Rr, Re, Rr, Re, Gs^Em, Gs^Fp, Gs^Fds, Gg, Gll^Fp, Gs^Fds, Gg, Gg, Gg, Wwg, Wo, Wo, Wo, Wo, Wo, Wo, Wo, Wo, Wo
Gs^Fdw, Gs^Fp, Ww^Ewf, Gg^Fet, Ww^Ewf, Re, Rr^Es, Rp, Gd, Gd, Gg, Ch, Re^Dr, Gll^Fmw, Re, Re^Es, Re, Gd, Rr, Re, Re, Gd^Es, Re^Es, Gs^Efm, Rr, Re, Gs^Vh, Re, Re, Gg^Fmw, Gg, Gs^Fms, Gs^Fms, Gs^Fds, Gs^Fds, Gg, Gg, Gll^Fp, Gll^Fp, Gs^Vl, Gg, Wwg, Wwg, Wwg, Wwg, Wwrg, Wo, Wo, Wo, Wo, Wo
Gs^Em, Gs^Fdw, Ww, Ww^Bw\, Gg, Rr, Rr^Dr, Gs^Efm, Gg, Chr, Ch, Gg, Ch, Re, Gg^Efm, Gs^Vc, Gs, Rr, Gd, Re, Re^Eff, Re^Eff, Re^Eff, Re^Eff, Gd^Eff, Gd, Gs, Gg^Es, Re^Es, Gs^Efm, Gs^Fms, Gs^Fms, Gs^Fds, Gs^Fds, Gg^Bw/r, Gll^Fp, Gll^Fp, Gll^Fp, Re, Re, Gll^Fp, Gg, Gg, Gg, Wwrg, Wwrg, Wwrg, Wo, Wo, Wo, Wo
Gs, Re^Wm, Ce, Re, Re^Es, Gg^Efm, Ch, Gg^Em, Re, Rb^Dr, Ch, Ch, Re^Dr, Gs, Gs^Fp, Ce, Gs^Fms, Gd^Fmw, Rb^Eff, Re^Eff, Rb^Es, Re, Re^Gvs, Gd^Gvs, Gd^Gvs, Gd^Eff, Re^Eff, Gs, Gs^Fmw, Re, Re, Gll^Fp, Re^Es, Gll^Fp, Gll^Fp, Re, Gg, Rb, Re, Gll^Fp, Gll^Fp, Gs^Fds, Gll^Fp, Gg, Gg, Wwg, Wwg, Wwg, Wwg, Wo, Wo
Ce, Ce, Re^Gvs, Ce, Ch, Ch, Re, Ch, Re^Es, 3 Kh, Gg, Gg, Rr^Vhc, Gs^Es, Gs^Fmw, Gs^Fp, Gs^Fmw, Re^Eff, Rb^Eff, Rb^Es, Rb, Re^Es, Re^Gvs, Re^Gvs, Re^Gvs, Re^Gvs, Gd^Gvs, Re^Eff, Re, Re^Gvs, Rb^Gvs, Re, Gll^Fp, Re^Es, Gs^Vh, Gll^Fp, Gs^Fds, Gg, Gll^Fp, Re, Re, Rb, Re, Gg, Gg, Gg, Gs^Fds, Wwg, Wwrg, Wo, Wo
Re^Gvs, Re^Gvs, Re^Gvs, Re, Re^Eff, Rr^Es, Gs^Vc, Ch, Gs^Em, Re, Gg, Rp, Chr, Gs^Em, Gs^Em, Gs^Fms, Mm, Re^Eff, Re^Gvs, Rb^Vh, Re^Es, Re^Gvs, Re^Wm, Re^Gvs, Re^Gvs, Re^Gvs, Gd^Es, Gs^Vc, Re^Es, Re^Gvs, Gg^Fmw, Gs^Fp, Gs^Em, Gs, Gs^Es, Gs^Es, Gs^Wm, Gll^Fp, Gg, Gll^Fp, Gg, Gll^Fp, Gg, Re, Gll^Fp, Gs^Fds, Gg, Ww^Ewl, Wwrg, Wo, Wo
Re^Gvs, Re^Gvs, Re^Gvs, Re^Gvs, Re^Eff, Re^Eff, Gs^Fp, Ch, Gs^Fmw, Re, Rr^Es, Re^Es, Re^Em, Gs^Fmw, Gs^Fmw, Gs, Gd, Gd^Gvs, Re^Gvs, Rb^Gvs, Re^Gvs, Re^Gvs, Re^Gvs, Re^Gvs, Re^Gvs, Gd, Gd^Es, Gd, Gs^Es, Gs^Eff, Gs^Eff, Gll^Fp, Gll^Emf, Gll^Fp, Gll^Fp, Gs^Emf, Gg, Gg, Gs^Fds, Gg, Gll^Fp, Gll^Fp, Gg, Rb, Gg, Gg, Gg, Gg, Gg, Ww^Ewf, Gg
Gg, Gs, Gs, Re^Eff, Gs^Fmw, Gs^Fmw, Gs^Fp, Ch, Gs^Fms, Gs^Fp, Re, Gs, Gs^Fp, Gs^Fp, Gs^Fp, Gs, Gs, Gd^Gvs, Re^Gvs, Re^Gvs, Re^Gvs, Re^Gvs, Re^Gvs, Re^Gvs, Re^Gvs, Gd, Re^Gvs, Gd, Gs, Gs^Eff, Gll^Fp, Gll^Fp, Gll^Fp, Gll^Fp, Gg, Gg, Gg, Gg, Gg, Gg, Gg, Gg, Gg, Gs^Fds, Gg, Gg, Gg, Gg, Gg, Gg, Wo
