Mm^Xm, Mm^Xm, Mm^Xm, Mm^Xm, Mm^Xm, Mm^Xm, Mm^Xm, Mm^Xm, Mm^Xm, Mm^Xm, Mm^Xm, Mm^Xm, Mm^Xm, Mm^Xm, Mm^Xm, Mm^Xm, Mm^Xm, Mm^Xm, Mm^Xm, Mm^Xm, Mm^Xm, Mm^Xm, Mm^Xm, Mm^Xm, Mm^Xm, Mm^Xm, Mm^Xm, Mm^Xm, Mm^Xm, Mm^Xm, Mm^Xm, Mm^Xm, Mm^Xm, Mm^Xm, Mm^Xm, Mm^Xm, Mm^Xm, Mm, Mm^Xm, Mm, Mm^Xm, Mm
Mm, Mm^Xm, Mm, Mm, Mm^Xm, Mm^Xm, Mm^Xm, Mm^Xm, Mm, Mm, Mm, Mm, Mm, Mm, Mm, Mm, Mm, Mm, Mm, Mm, Mm, Mm, Mm, Mm, Mm, Mm^Xm, Mm^Xm, Mm^Xm, Mm, Mm, Mm, Mm, Mm, Mm, Mm, Mm, Mm^Xm, Mm^Xm, Mm, Mm^Xm, Mm, Mm^Xm
Mm, Mm, Mm, Mm, Mm, Mm^Xm, Mm^Xm, Mm^Xm, Mm, Mm, Hh, Hh^Fmf, Hh^Fmf, Mm, Hh, Rrc, Gd, Hh, Gs, Hh, Gd, Hh, Hh, Mm, Hh, Mm, Wwr, Hh, Gs^Vl, Ww, Gg, Gg^Es, Gg^Fms, Mm, Mm, Mm^Xm, Mm^Xm, Mm, Mm, Mm, Mm, Wwr
Mm, Mm, Gll^Fmf, Mm, Mm, Mm, Hh, Mm, Hh, Hh^Em, Gd, Gd^Fmf, Ch, Gs, Mm^Xm, Mm^Xm, Mm^Xm, Gg, Ch, Gs, Rr, Gd, Rr, Rr, Ww, Ww, Mm, Mm, Gg^Ebn, Ww, Ww, Dd^Do, Gg^Ecf, Gg^Fms, Mm, Mm^Xm, Mm^Xm, Mm, Hh^Fmf, Mm, Hh^Em, Mm
Mm, Mm, Hh^Fmf, Hh^Vhhr, Rp^Fmf, Hh, Mm, Wwr, Ww, Re, Re, 3 Kh, Rr^Vhc, Gs, Mm^Xm, Mv, Mm^Xm, Gd, Rr^Vhc, 4 Kh, Gd, Rr, Ww, Ww, Gs, Mm, Mm^Xm, Mm^Xm, Mm, Ww, Ww, Gg, Mm, Mm, Mm^Xm, Mm^Xm, Mm, Mm, Rp, Rp, Ww^Bsb\, Ww
Mm, Mm, Aa, Re, Hh^Fmf, Hh^Fmf, Mm^Xm, Mm, Mm, Ww, Gd, Ch, Ch, Gd, Gg, Mm^Xm, Gg, Gd, Ch, Ch, Gll^Fmf, Gll^Fmf, Ww, Gs, Hh, Mm, Mm^Xm, Mm, Mm, Gg, Ww, Gg^Fms, Mm, Mm, Mm^Xm, Mm, Mm, Rp, Gs^Fmf, Gd^Fmf, Ww, Chw
Mm, Mm, Aa, Re, Gd^Fmf, Mm, Mm^Xm, Mm^Xm, Mm, Ww, Ww, Gd^Es, Gd, Ch, Rrc, Gd^Fet, Rrc, Ch, Gs^Fmf, Gd^Fmf, Ww, Ww, Gs^Fmf, Gs^Fmf, Ha, Mm, Mm^Xm, Mm, Mm, Gg, Ww, Gg^Fms, Mm, Mm^Xm, Mm, Mm, Hh^Edt, Rp, Kvr, Cvr, Ww, Ww
Mm, Mm, Cf, Gs^Fmf, Gd, Mm, Mm^Xm, Mm^Xm, Mm, Gs, Ww, Rb^Gvs, Rb^Gvs, Aa, Gd, Rrc, Gd, Gs, Ww^Ewl, Ww, Ww, Ww^Ewf, Gs^Fmf, Hh^Fmf, Mm, Mm, Mm^Xm, Mm^Xm, Mm, Gg^Fms, Mm, Ww^Ewl, Mm, Mm, Mm, Hh^Vhh, Rp, Rp, Ww, Ww, Ww, Gs
Mm, Mm, Cf, Gd, Gd, Mm, Mm, Mm^Xm, Mm, Ww^Ewf, Ww, Rb^Gvs, Rb^Gvs, Rb^Gvs, Gs, Rrc, Gd^Fmf, Gs, Ai, Ww, Gs, Gd^Fmf, Ha^Fda, Gd, Mm, Mm, Mm^Xm, Mm, Mm, Mm, Mm, Ww, Mm, Mm, Rp, Rp, Gs^Fmf, Ww, Ww, Ww, Gd, Wwr
Mm, Mm, Cf, Cf, Gd^Fmf, Mm, Mm, Mm^Xm, Mm, Gs^Fmf, Gs, Ww, Ww, Rb^Gvs, Gd, Rrc, Gd^Fmf, Gg^Fmf, Ww, Gs, Gs^Fmf, Hh^Fmf, Mm, Mm, Mm^Xm, Mm^Xm, Mm, Mm, Mm, Mm, Mm, Ww, Ww^Bw/, Rp, Aa, Gll^Fmf, Ww, Ww, Ww, Gd, Ss, Ss
Mm, Mm, 2 Kf, Cf, Hhd^Fmf, Hhd^Fmf, Mm, Mm^Xm, Mm, Hh^Fmf, Gs, Ww, Ww, Gg, Gd, Rrc, Ww, Ww, Ker, Gs, Hh^Fmf, Mm, Mm^Xm, Mm^Xm, Mm, Mm, Mm, Mm, Hh^Fmf, Mm, Rp, Rp, Ww, Ww, Ww, Ww, Ww, Ww, Gs, Gd, Ss^Vhs, Ss
Mm, Mm, Cf, Re, Hhd^Fmf, Hhd, Mm, Mm^Xm, Mm^Xm, Mm, Hh, Gd, Gd^Edt, Ww, Ww, Rrc, Ww, Chw, Gd, Hh, Hh^Fmf, Mm, Mm^Xm, Mm, Hh^Fmf, Cud, Rp, Hh, Rp, Hh, Chw, Gd^Fmf, Chw, Ww, Ww, Ww, Ww, Gg, Ss, Ss, Chs, Ss
Mm, Mm, Hhd^Fmf, Rb, Gd^Fmf, Hhd^Em, Hhd^Es, Mm, Mm^Xm, Mm, Mm, Hh, Gs^Vc, Gd, Gd, Ww^Bsb|, Ww, Gs, Gs, Hh^Fmf, Hh^Fda, Mm, Mm^Xm, Mm, Hh^Vhh, Rp, Gd^Fmf, Hh^Fmf, Hh^Fmf, Rp, Hh^Fmf, Chw, Ww, 5 Khw, Chw, Chw, Gs, Gd, Rb, Ss, Ww^Ewf, Ww^Ewl
Mm, Mm, Hhd, Rr^Fmf, Rr, Gd^Fmf, Hhd, Mm, Mm, Mm^Xm, Mm^Xm, Mm, Mm, Mm, Mm, Rr, Ww, Gd, Gs, Hh^Fmf, Hh^Vhh, Mm, Mm^Xm, Cud, Kud, Rp^Fmf, Hh^Fmf, Hh^Fmf, Qxu, Hh^Fmf, Hh^Fmf, Ai, Ww, Ww, Ww, Gd^Fmf, Aa^Fda, Cer, Ww^Ewf, Rb, Ss^Bw|r, Wwr
Mm, Mm, Mm, Hhd^Vhhr, Hhd^Fmf, Rr, Rp, Aa, Aa^Fmf, Cte, Kte, Mm^Xm, Mm, Mm, Mm, Rr, Chw, Ww, Gd, Gd^Fmf, Rb, Mm, Mm, Mm^Xm, Mm, Rp, Hh, Gd^Fmf, Ww^Ewl, Qxu, Wog, Wog, Wog, Ww, Gll^Fmf, Gll^Fmf, Ww^Ewf, Ss, Ss, Ss, Ss^Bw|r, Gs^Ftp
Mm, Mm, Mm, Hhd, Hhd^Fmf, Hhd^Fmf, Gs^Fmf, Rp, Hhd, Aa^Fda, Hhd^Fmf, Mm, Mm, Mm, Mm, Re, Gs, Ww, Ww, Gd^Fmf, Rb, Gd^Fmf, Gd^Fmf, Mm^Xm, Mm, Rp, Gd, Hh^Fmf, Wwrg, Ss, Ww, Ww, Wog, Wwg, Wwg, Gll^Fmf, Ss, Ss, Ss, Ww^Ewf, Chs, Gs^Ftp
Mm^Xm, Mm, Mm, Mm, Wwf, Hhd, Hhd, Rp, Rp, Hhd^Fmf, Gd^Fmf, Hhd, Mm, Mm, Mm, Re, Gs^Fmf, Hhd^Fmf, Wwf, Wwf, Ww, Gd^Fmf, Rp, Gll^Fmf, Mm, Mm, Gd^Vh, Wwg, Wwf, Ww, Cfr, Ww, Wwg, Wog, Ww^Ewl, Wwg^Ewl, Qxu, Ss, Ss, Ker, Wwrg, Rp
Mm^Xm, Mm, Hh, Wwf, Mm, Ww, Ww, Ww^Ewf, Ww, Rp, Ai, Gd^Fmf, Hhd^Fmf, Mm, Hhd^Vhh, Re, Gll^Fmf, Hhd^Fmf, Rb, Wwf, Ww, Rp, Gs, Gd, Re, Rp, Wwg, Wwf, Ww, Cfr, Gd^Em, Cfr, Wwg, Wog, Wog, Gd, Qxu, Ss, Ss, Wwrg, Wwg, Ss
Mm^Xm, Mm^Xm, Hh, Ha, Mm^Xm, Mm, Mm^Xm, Gd, Mm, Ww, Gd, Ai, Re^Em, Hhd^Fmf, Hhd^Fmf, Re, Re, Re, Gll, Gd, Gd, Ww, Rb, Rb, Ww, Chw, Ww, Ww, Ww, Cfr, Gs, Gs, Wwg, Wog, Wog, Wog, Ss, Wwrg, Ss^Bw/r, Ss^Vhs, Sm, Chs
Mm, Mm^Xm, Gd, Ha, Mm, Mm^Xm, Mm^Xm, Mm^Xm, Mm^Xm, Mm, Gd, Ww, Re, Gd^Fmf, Khr, Gs^Fmf, Gs^Fmf, Re, Gd, Aa^Fda, Re, Ww^Bw/, Ww, Ww, Ww, Ww, Mm^Xm, Ww, Ww^Bsb/, Cfr, Gs, Gd^Fmf, Gd, Wwg, Wwg, Wwrg, Wwf, Gll, Ss, Ss, Qxu, Sm
Mm, Mm, Gd, Hhd, Hhd^Fmf, Mm, Mm, Mm, Mm, Mm, Gs, Ww, Re, Rb, Chw, Rb, Chr, Re, Re, Re, Ww, Ww, Ww, Ww, Ww, Ww, Mm^Xm, Gd^Fmf, Gd, Ww, Ww, Ww, Ww, Wwf, Re, Wwf, Ss, Wwg, Wwg, Ss, Wwg^Ewl, Qxu
Mm, Mm, Mm, Hhd, Hhd^Fmf, Hhd^Fmf, Aa^Fda, Mm, Hhd, Gd^Es, Gd, Ww^Bw/r, Ww, Ww, Ww, Chw, Khw, Gs^Fmf, Re, Ww, Ww, Ww, Ww^Ewf, Gd, Gd^Fmf, Ww, Gll, Gd^Fmf, Gs, Gd^Vo, Gd, Gd, Gd^Fmf, Re, Gd, Ss, Sm, Ss, Ss, Wwf, Wog, Wog
Mm, Mm, Mm, Gd^Vh, Gs^Fmf, Gd, Aa, Aa^Fda, Gd, Hhd, Gd, Ww, Ww, Ww, Wo, Ww, Ww, Ww, Ww^Bw|, Ww, Ww, Ww, Gd, Gd, Gs^Fmf, Gs^Fmf, Gll, Gs^Fmf, Gs^Fmf, Gd^Fmf, Gd^Fmf, Gd^Fmf, Kvr, Gd^Fmf, Gd^Fmf, Gd, Chs, Gd, Gd, Chw, Wwg, Wwg
Hhd, Mm, Hhd^Fmf, Gd, Gs^Fmf, Gs^Fmf, Gd, Gd^Fmf, Gd^Fmf, Gd^Fmf, Gd, Ww, Wo, Wo, Wo, Ww, Ww, Ww, Ww^Bw|, Ww, Gd, Ww, Gd, Gs^Fmf, Gd^Fmf, Gd^Fmf, Gd^Em, Aa, Gd^Fmf, Gs^Fmf, Gd, Gd^Fmf, Re, Gd^Fmf, Gd^Fmf, Gd, Gd, Sm, Gs, Ww, Ww, Wwg
Hhd, Hhd, Hhd^Fmf, Gd^Fmf, Gs, Gd, Ww, Ww, Ww, Gd, Ww, Ww, Wo, Wo, Ww, Ww, Ww, Ww, Rp, Gd, Gll^Fmf, Gd, Gd^Fmf, Aa^Fmf, Gd^Fmf, Gd, Re^Vct, Gd, Gd, Gd^Fmf, Re, Re, Gd^Fmf, Gd, Gs^Efm, Gd^Fmf, Re, Aa, Re, Ww, Ww, Ww
Hhd, Hhd, Gs^Fmf, Gs^Fmf, Gd, Ww, Ww, Wo, Wo, Ww, Wo, Wo, Ww, Ww, Ww, Ww, Gd, Gd^Vo, Rp, Gd^Fmf, Gd^Fmf, Gd^Fmf, Gd, Gd, Gd, Gd^Fmf, Co, Co, Co, Re, Gd, Gs, Gd^Fmf, Re, Re, Re, Gd, Gd, Gs, Re, Ww, Ww
Gd, Gd^Fmf, Gs, Gd^Edt, Wwf, Wwf, Ww^Ewf, Wo, Ww, Wo, Ww, Ww, Ww, Ww, Gd, Gd, Gd^Fmf, Gd, Re, Gll^Fmf, Gd^Fmf, Gd^Fmf, Re^Vct, Gd, Gd, Gd, Co, Gs, Gs, Re^Vct, Gd, Gd^Fmf, Gd^Fmf, Gd^Fmf, Gg^Fmf, Gs^Fmf, Gs^Fmf, Gs, Gs, Gs^Es, Gd, Ww
Ww, Gd, Ww, Ww, Wo, Gg^Fet, Wwf, Gg^Ecf, Wwf, Wwf, Ww, Ww, Gd, Gd, Gd^Fmf, Gd^Fmf, Gd^Fmf, Gd, Re, Gd, Gd^Fmf, Gd^Fmf, Co, Co, Co, 1 Ko, Gs, Co, Gd^Edt, Gd^Edt, Gd^Fmf, Gd^Fmf, Aa^Fmf, Gd^Fmf, Gs^Fmf, Aa^Fmf, Gs^Fmf, Gd^Fmf, Gd^Fmf, Gd, Gd^Fmf, Ww
Ww, Ww, Ww, Wo, Wo, Ww, Ww^Ewf, Ww^Ewf, Gd, Gd, Gd, Gd, Gs^Fmf, Gs^Fmf, Gd^Fmf, Gd^Fmf, Gd, Re, Gd, Gd^Fmf, Gd, Re, Co, Gs, Co, Gs, Gd, Gd, Gs^Fmf, Gd, Aa^Fmf, Gd^Fmf, Aa^Fda, Gd^Fmf, Gd^Fmf, Aa^Fmf, Aa^Fda, Gs^Fmf, Aa^Fmf, Gd^Fmf, Gd^Fmf, Gd^Fmf
Ww, Ww, Wo, Wo, Ww, Ww, Ww, Gd, Gll^Fmf, Gll^Fmf, Gs, Gs, Aa^Fmf, Aa^Fmf, Gd, Gg, Gd^Es, Re, Re, Gd, Re, Gd, Re^Vct, Gs, Gg, Aa, Gll^Fmf, Gs^Fmf, Aa^Fda, Gd^Fmf, Aa, Aa, Aa^Fda, Gd, Aa, Aa^Fda, Gd^Fmf, Gd^Fmf, Gd^Fmf, Aa^Fda, Gd^Fmf, Gd^Fmf
Wo, Wo, Ww, Ww, Ww, Ww, Gll^Fmf, Gd, Gll^Fmf, Gs, Gs, Gs^Fmf, Gs^Fmf, Aa, Gd, Gd, Gd^Fmf, Gd, Re, Re, Gd, Gd, Gs, Gg^Edt, Gll^Fmf, Aa, Aa^Fmf, Gg, Aa^Fda, Aa^Fda, Aa^Fda, Aa^Fda, Aa, Aa, Aa, Gd, Gd^Fmf, Gd, Gd, Gd^Fmf, Gll^Fmf, Gll^Fmf
Wo, Ww, Ww, Ww, Gd, Gd, Gll^Fmf, Gll^Fmf, Gll^Fmf, Gll^Fmf, Gd, Gd, Gd, Gd^Fmf, Aa^Fmf, Gd^Fmf, Gd, Gd, Aa, Gd, Gd, Aa, Gd, Aa^Fmf, Gd, Aa^Fda, Gd^Fmf, Gg^Fmf, Gd, Aa^Fda, Gll^Fmf, Aa, Aa, Aa, Gd, Gd^Fmf, Gd, Gd, Gll^Fmf, Gll^Fmf, Gll^Fmf, Gll^Fmf
