Wo, Wo, Wo, Wo, Wo, Wo, Dd, Ww, Dd^Dc, Wwt, Ww, Wo, Wo, Wo, Wo, Wo, Wo, Wo, Wo, Ww, Wo, Ww, Wo, Wo, Wo, Wo, Wo, Ww, Gg, Gg, Mm, Mm, Mm, Mm, Mm, Mm^Xm, Mm^Xm, Mm^Xm, Mm^Xm, Gd, Mm^Xm, Mm^Xm, Mm^Xm, Mm, Mm^Xm, Mm, Mm^Xm, Mm, Mm^Xm, Mm, Mm, Mm, Mm, Mm, Mm, Mm, Mm, Mm, Mm, Mm, Mm, Mm, Gd, Gd, Gd, Gd, Gd, Rp, Rp, Gd, Gd, Gd, Gd, Gd, Gd, Gd, Ss
Wo, Wo, Wo, Wo, Wo, Ww, Ww, Dd, Wo, Dd, Dd^Vda, Ww, Ww, Wo, Wo, Wo, Wo, Wo, Wo, Wo, Wo, Wo, Wo, Wo, Wo, Wo, Wo, Ww, Gg, Gg, Mm, Mm, Mm, Mm, Mm, Mm^Xm, Mm^Xm, Mm^Xm, Mm^Xm, Mm^Xm, Mm, Mm^Xm, Mm^Xm, Mm^Xm, Mm^Xm, Mm^Xm, Mm, Mm^Xm, Mm, Mm^Xm, Mm, Mm, Mm, Mm, Mm, Mm, Mm, Mm, Mm, Mm, Mm, Mm, Ce, Ce, Ce, Gd, Gd, Gd, Rp, Rp, Gd, Gd, Gs, Gd, Ss, Ss, Ss
Wo, Wo, Wo, Wo, Wo, Wo, Wo, Ww, Ww, Ww, Ww, Ww, Ww, Ww, Ww, Wo, Wo, Wo, Wo, Wo, Wo, Wo, Wo, Wo, Wo, Wo, Ww, Ww, Gg, Gg, Mm, Mm, Mm, Mm, Mm, Mm, Mm^Xm, Mm, Mm^Xm, Mm^Xm, Mm^Xm, Mm^Xm, Mm^Xm, Mm^Xm, Mm^Xm, Mm, Mm, Mm, Mm, Mm, Mm, Mm, Mm, Mm, Mm, Mm, Gd, Mm, Wwg, Wwg, Rp^Vct, Ce, Ce, 3 Ke, Ce, Rp, Rp, Rp, Gd, Gd, Gd, Gd, Ss, Ss, Ss, Ss, Ss
Wo, Wo, Wo, Wo, Wo, Wo, Wo, Ww, Wwr, Ww, Dd, Dd, Ww, Ww, Ds, Ww, Ww, Wo, Wo, Wo, Wo, Wo, Wo, Wo, Ww, Ww, Ww, Gg, Gg, Gg, Mm, Mm, Mm, Mm, Mm, Mm, Mm, Mm^Xm, Mm^Xm, Mm^Xm, Mm^Xm, Mm^Xm, Mm^Xm, Mm^Xm, Mm^Xm, Mm^Xm, Mm, Mm, Mm, Mm, Gd, Mm, Gs, Gd, Gd, Gd, Gs, Gd, Chw, Ww^Ewl, Rp, Re, Re^Vct, Ce, Gd, Rp, Gs, Gd, Wwg, Gs, Wwg, Gs, Wwg, Wwg, Wwg, Ss, Ss
Wwt, Ww^Vm, Wwr, Wo, Wo, Wo, Ww, Wwr, Wwr, Wwr, Gs^Ft, Gs^Ft, Gs^Ft, Ww, Ds, Ds, Ww, Wo, Wo, Wo, Wwg, Wo, Wo, Wo, Ww, Ww, Gg, Gg, Gg, Gg, Gd, Mm, Mm, Mm, Mm, Mm, Mm, Mm, Mm, Mm^Xm, Mm^Xm, Mm^Xm, Mm^Xm, Mm^Xm, Mm^Xm, Mm, Mm, Mm, Mm, Gd, Gd, Gs, Gd, Gs, Gs, Gs, Gs, Gd, Wwg, Wwg^Bw\r, Gg, Gd, Gd, Gd, Gs, Wwg, Gs, Wwg, Wwg, Wwg, Ss, Wwg, Wwg, Wwg, Ss, Gll^Fdw, Ss
Wo, Wwr, Wwr, Wo, Wo, Wo, Wo, Ww, Ww, Dd, Dd, Wwg, Ds, Ds, Ds, Chw, Ww, Wo, Wwrg, Wwg, Wo, Ww^Ewl, Wwr, Ww, Mm, Ww, Gg, Gg, Gs^Vc, Gg, Re, Mm, Gg, Mm, Gg^Esd, Mm, Mm, Mm, Mm, Mm, Mm, Mm, Mm, Mm^Xm, Mm, Mm, Mm, Mm, Mm, Gg, Hh, Gs, Gs, Gs, Gs, Gs^Fetd, Rp, Rp, Ce, Wwg, Wwg, Gg, Wwg, Gs, Wwg, Gs, Wwg, Wwg, Wo, Wwg, Ss, Ss, Ss, Ss, Ss, Ss, Ss
Wo, Wo, Wo, Wo, Wo, Wo, Wo, Wo, Wo, Ww, Ww, Dd, Chw, Ds, Chw, 5 Km, Ww, Wwrg, Wwrg, Ww, Ww, Ww, Wwrg, Ww, Ww, Ww, Gg, Gg, Gg, Gg, Rp, Gg, Gg, Gg, Gg^Esd, Gg^Esd, Gd^Esd, Mm, Mm, Mm, Mm, Mm, Mm, Mm^Xm, Mm, Mm, Mm, Mm, Hh, Gg^Vhh, Hh, Gs, Gs, Gs, Gg, Rp, Re, Ce, Wwg, Wwg, Wwg, Gg, Wog, Wog, Wog, Wog, Wog, Wo, Wog, Wwg, Ss, Gll^Feth, Ss, Ss, Ss, Gll^Fdw, Ss
Wo, Wo, Wo, Wo, Wo, Wo, Wo, Wo, Wo, Wo, Wo, Chw, Wwr, Chw, Ww, Ww, Wo, Wo, Wo, Wwg, Wwf, Ww, Wo, Wwrg, Wwf, Ww, Ww, Gg, Gg, Gg, Gg, Rb, Rp, Rp, Rp, Gg^Esd, Gd^Esd, Gs^Esd, Gd^Esd, Mm, Mm, Mm, Mm, Mm, Mm, Mm, Mm, Mm, Mm, Hh, Hh, Hh, Hh, Gs, Gs, Rp^Vct, Sm, Ce, Ce, Wwg, Gg, Wog, Wog, Wog, Gd, Ww^Ewl, Wwf, Ss, Ss, Wog, Wog, Ss, Ss, Gd^Fetd, Ss, Ss, Ss
Wo, Wo, Wo, Wo, Wo, Wo, Wo, Wo, Wo, Wo, Wo, Wo, Ww, Wwr, Ww, Wwr, Wo, Wo, Wwg, Wwf, Cme, Cme, Ww, Ww^Ewl, Wwg, Wwg, Ww, Gg, Ww, Ww, Ww, Ww, Gg^Em, Rb^Es, Gg, Re, Re, Gd^Esd, Re, Gg, Gg^Em, Hh^Vhh, Mm, Mm, Mm, Mm, Gg, Mm, Mm, Mm, Hh, Hh, Hh, Gs, Gs, Gg^Edt, Sm^Bw|r, Gd, Gll^Fdw, Gg, Gd, Gd, Gd, Gg, Wog, Wwf, Ss, Wwg, Wwrg, Wwr, Wog, Wog, Wwg, Sm, Sm, Ss, Ss
Wo, Wo, Wo, Wo, Wo, Wo, Wo, Wo, Wo, Wo, Ww, Ww^Vm, Ww, Ww, Wo, Wo, Wo, Wo, Wwg, Wwf, Ww^Ewf, Sm, Ww^Ewl, Ww, Wwg, Ww, Wwr, Ww, Ww, Ww, Ww, Ww, Ww, Gg^Em, Re^Em, Rp, Rp, Rp, Rb, Rb^Em, Rp, Gg, Mm, Mm, Mm, Gg, Ce, Mm, Mm, Mm, Qxu, Hh, Hh, Hh, Gs, Ww^Ewf, Rp, Gd, Gll^Fdw, Gd^Fdw, Gd, Gd, Gg, Ss, Wog, Ss, Wwg, Wwf, Wwr, Wwrg, Wwg, Wog, Wwg, Wwg, Wwg, Sm, Ss
Wo, Wo, Wo, Wo, Wo, Wo, Wo, Wo, Wo, Wo, Wo, Ww, Wwg, Ww, Wwg, Wo, Wwg, Wwg, Sm, Ww, Ww^Ewl, Wwg, Wwg, Wwg, Wwg, Ww, Wo, Wo, Wo, Ww, Wo, Ww, Wo, Gg^Es, Gg, Gg^Es, Re, Re, Gs, Rp, Rp, Gg, Gg, Mm, Gg, Khr, Gs, Hh^Vhh, Mm, Mm, Hh, Qxu, Qxu, Hh, Hh, Gs, Gs^Fdw, Rp^Fdw, Gd^Fdw, Gd^Fdw, Gg, Gd, Ss, Ss, Ww^Ewl, Wwg, Wwg, Ss, Wog, Gd, Gg, Wog, Ss^Vhs, Ss, Sm, Gs, Ss
Wo, Wo, Wo, Wo, Wo, Wo, Wo, Wo, Wo, Wo, Wo, Sm, Wwg, Ww^Ewl, Wwg, Sm, Sm, Sm, Wwg, Sm, Ww, Ww^Ewl, Wwg, Wo, Wo, Wo, Wo, Wo, Ww, Ww, Ww, Ww, Wo, Ww, Ww, Gg, Re, Gg, Gs, Gs^Edt, Gs, Rp, Rp, Gg, Rp, Gg, Gs, Gs, Gs, Mm, Gg, Hh, Hh, Hh, Hh, Hh^Fdw, Hh, Rp, Rp, Ss, Sm, Ss, Wog, Wog, Ss, Ss, Wwg, Wog, Wog, Ss, Wog, Gg, Ss, Sm, Sm, Sm, Gg^Es
Ww, Ww, Wo, Wo, Wo, Wo, Wo, Wo, Wo, Wo, Wwg, Ww, Wwg, Sm, Sm, Wwg, Wwf, Wwf, Wwg, Chs, Wwg, Wwg, Wwf, Wo, Wo, Wo, Wo, Wo, Wo, Ww, Ww, Wo, Ww, Wo, Wo, Wwf, Wwf, Wwf, Ww, Gs^Em, Gg, Gs, Gs, Rp, Gs, Rp, Rp, Gg^Efm, Gs^Efm, Gs^Efm, Gs^Efm, Gs^Es, Gg, Khr, Qxu, Hh, Hh, Gll^Fdw, Rb, Ss, Sm, Sm, Ww^Ewl, Wwf, Sm, Wwg, Ww^Ewl, Wwg, Wwg, Wog, Wog, Wog, Sm, Ss, Ss, Sm, Sm
Ww, Ww, Ww, Wo, Ww, Ww, Ww, Wo, Gll^Fdw, Wwg, Wwg, Ww, Wwf, Wwf, Sm, Ww^Ewl, Wwf, Ww^Ewl, Ww, Sm, Wwg, Wwf, Wo, Wo, Wo, Wo, Wo, Wo, Ww, Wo, Ww, Wo, Wwr, Ww, Ww, Wwf, Wwf, Wwf, Ww, Ww, Ww, Ww^Ewl, Ww^Ewl, Ww^Ewl, Gg, Gs, Gs, Rp, Re, Gs, Re, Gs, Gs, Gs, Hh, Qxu, Hh, Cer, Hh, Sm^Bw\, Rp, Sm, Gg, Sm, Chs, Wwg, Wwg, Ww, Wwg, Wwg, Gs^Eff, Sm, Rb^Gvs, Gg, Gs^Vl, Ss, Sm
Ww, Ww, Ww, Ww, Ww, Ww, Ww, Ww, Gll^Fdw, Wwg, Chs, Wwg, Wwf, Ww, Ss, Gll^Fmw, Wwg^Bw\r, Ww, Ww, Ww, Wo, Wo, Wo, Wo, Wo, Wo, Wo, Wo, Ww, Wwr, Ww, Ww, Gs^Fds, Gs^Fds, Gs^Fds, Wwf, Cme, Wo, Wo, Wo, Wo, Ww, Ww, Ww^Ewl, Ww, Gs, Gs, Gs^Edb, Gs, Re, Rp, Gs^Vc, Gg, Gg, Gg^Esd, Qxu, Gg, Hh, Gs^Vc, Hh, Rp, Gg, Rp, Rp, Rp, Wwg, Wwg, Wwg, Gs^Eff, Gs^Eff, Rb^Gvs, Wog, Rb^Gvs, Rb^Gvs, Rb^Gvs, Rb, Ss
Gll^Fdw, Ww, Gll^Fdw, Ww, Ww, Ww, Ww, Wwg, Wwg, Wwg, Wwg, Ww, Ww, Ww, Ww, Ww, Ww, Ss, Wo, Chw, Wo, Wo, Wo, Wo, Wo, Wo, Wo, Wo, Ww, Gs^Fds, Gs^Fds, Gs^Fds, Gs^Fds, Gs^Fds, Re, Re, Gs^Fds, Gs, Ww, Ww, Wwr, Wo, Wo, Wo, Wo, Ww, Wo, Gg, Gg, Gs, Ww^Ewf, Rp, Rp, Gg, Rp, Gg, Rp, Gg, Rp, Rp, Rp, Re, Gg, Gg, Ww, Ww^Bw\, Rp, Gg, Gs^Es, Gs^Eff, Gs^Eff, Rb^Gvs, Rb^Gvs, Rb^Gvs, Ss, Ss, Ce
Gll^Fdw, Gll^Fdw, Gll^Fmw, Gll^Fdw, Gll^Fdw, Ww, Ww, Wwg, Gll^Fmw, Wwrg, Wwg, Ss, Wwg, Wwrg, Sm, Sm, Wo, Wo, Wo, Wo, Wo, Wo, Wo, Wo, Wo, Wo, Wo, Wo, Wwr, Gs^Fds, Gs^Fds, Gs^Fds, Gs^Fds, Gs^Fds, Gs^Fds, Gs^Fds, Gs^Fds, Gs^Fds, Gs^Fds, Ww^Ewl, Gs^Fds, Ww, Gs^Fds, Ww, Wwr, Wo, Ww^Ewf, Wo, Wo, Ww, Ww, Re, Re, Rp, Gg, Rp, Gg^Esd, Rp, Ww, Re, Gg, Gg, Ww, Ww, Chw, Re, Re, Rp, Rp^Es, Gg, Rp, Gs^Eff, Gg^Eff, Gs^Eff, Gg, Ss, Ce
Gll^Fdw, Gll^Fdw, Gll^Fdw, Gll^Fmw, Gll^Fdw, Hhd, Ww, Ww, Gll^Fdw, Wwg, Wwg, Wwg, Gll^Fmw, Wwg, Gll^Fmw, Wo, Rb^Fdw, Wo, Wo, Wo, Wo, Wo, Wo, Wo, Wo, Wo, Wo, Gg, Ww, Wwr, Gs^Fds, Gs^Fds, Re, Re, Cv, Gs^Fds, Gs^Fds, Gs^Fds, Gs^Fds, Gs^Fet, Gs^Fds, Gs^Fds, Gs^Ve, Gs^Fds, Gs^Fds, Ww, Ww, Ww, Ww, Wo, Wo, Ww, Ww, Chw, Ww, Gg, Ww, Ww^Ewl, Ww, Ww, Ww, Ww, Ww, Ww, Ww, Gg, Gg^Edb, Gg, Gg^Em, Rb, Rp, Rp, Re, Gg^Edt, Rp, Re^Vct, Rp
Qxu, Ss, Gll^Fmw, Gll^Fmw, Gll^Fmw, Hhd, Sm, Ww, Gll^Fmw, Wwg, Sm, Ss, Wwg, Wwg, Gll^Fp, Wwrg, Wwrg, Wo, Wo, Wo, Wo, Wo, Wo, Wo, Wo, Wo, Wo, Ww^Ewl, Ww, Ww, Gs^Fds, Gs^Fds, Gs^Fds, Cv, 2 Kv, Cv, Cv, Gs^Fds, Re, Gs^Fds, Re, Gs^Fds, Gs^Fds, Re, Re, Re, Gs^Efm, Gs^Efm, Gs^Efm, Ww, Ww, Wo, Wo, Ww, Ww, Ww, Ww, Ww, Ww, Ww, Ww, Ww, Wo, Ww, Wwf, Wwf, Ww, Gg, Gg, Gg^Es, Gg, Re, Gg, Rp, Ai, Rp, Gg
Qxu, Gll^Fdw, Gll^Fmw, Rb, Rb^Fdw, Gll^Fmw, Rb^Fdw, Rb^Fdw, Gll^Fdw, Gll^Fdw, Gll^Fdw, Gll^Fdw, Gll^Fdw, Wwg, Wwg, Wo, Wo, Wo, Wo, Wo, Wo, Wo, Wo, Wo, Wo, Wo, Wo, Wo, Ww^Ewl, Ww, Gs^Fds, Gs^Fds, Gs^Fds, Cv, Cv, Cv, Gs^Ve, Re, Gs^Fds, Re, Gs^Fds, Gs^Fds, Ww, Gs^Fds, Ww, Gs^Efm, Wwrg, Ww, Ww, Ww, Ww, Ww, Wo, Wo, Wo, Wo, Wo, Wo, Wo, Ww, Wo, Wo, Ww, Wwf, Wwf, Ww, Wo, Ww, Ww, Gg, Ce, Ce, Ce, Gd, Gd, Sm, Ss
Qxu, Qxu, Sm, Gll^Fdw, Gll^Fdw, Gll^Fp, Gll^Fdw, Ss^Em, Gll^Fdw, Gll^Fp, Ww, Ww, Ww, Ww, Ww, Wo, Wo, Wo, Wo, Wo, Wo, Wo, Wo, Wo, Wo, Wo, Wo, Wo, Ww, Wwr, Ww, Gs^Fds, Gs^Fds, Cv, Gs^Fds, Gs^Fds, Ww, Gs^Fds, Ww, Ww^Esd, Wo, Ww, Wo, Ww, Wo, Ww, Ww^Ewf, Ww, Wwrg, Wo, Wo, Wo, Ww, Ww, Ww, Ww, Ww, Wo, Ww, Ww, Ww^Ewl, Wo, Ww, Wwf, Gg^Em, Ww, Wo, Wo, Ww, Ww, Chw, Ce, Ce, Ce, Gg, Sm, Sm
Wo, Sm, Gll^Fdw, Ss, Qxu, Gll^Fdw, Rb, Gll^Fdw, Gll^Fp, Rb, Rb^Fdw, Ww, Ww, Ww, Ww, Wo, Wo, Wo, Wo, Wo, Wo, Wo, Wo, Wo, Wo, Wo, Wo, Wo, Wo, Ww, Ww, Gs^Fds, Gs^Fds, Gs^Fds, Ww, Wwr, Ww, Ww, Wo, Wo, Ww, Wo, Ww, Wo, Ww^Ewl, Wo, Ww, Ww^Bw\r, Re, Ww, Wwg, Wwg, Gg, Gg^Efm, Gs, Gs, Gs, Ww^Ewf, Ww, Ww, Ww^Ewl, Wo, Ai, Ds^Em, Gg, Ww, Ww, Wo, Wwf, Wwf, Wwf, Ww, Ww, 1 Ke, Ww, Gg, Gs
Wo, Rb, Hhd, Gll^Fdw, Rb, Qxu, Hhd, Gll^Fdw, Gll^Fp, Gll^Fmw, Ss^Em, Rb^Fdw, Gll^Fp, Ww, Ww, Ww, Wo, Wo, Wo, Wo, Wo, Wo, Wo, Wo, Wo, Wo, Wo, Wo, Wo, Wo, Wo, Ww, Ww, Ww, Wo, Ww, Wo, Wo, Wo, Ww^Ewl, Ww, Ww, Gg, Ww, Gs, Ww, Ds, Re, Gs, Chw, Wwg, Gg^Ecf, Gs^Efm, Gs^Efm, Gs, Gs, Gs, Wwr, Wwg, Ww, Gs^Eff, Gs^Eff, Rb^Gvs, Ds^Eff, Gs^Eff, Ww^Bw\r, Gs, Wwf, Wwf, Wwf, Wo, Wwf, Ww, Ww, Ww, Sm, Wo
Wo, Hhd, Hhd^Fmw, Rb^Fdw, Sm^Edb, Hhd^Fmw, Hhd^Emf, Hhd^Fp, Gll^Fdw, Gll^Fdw, Wwg, Gll^Fmw, Gll^Fmw, Gll^Fmw, Sm, Ww, Wo, Wo, Wo, Wo, Wo, Wo, Wo, Wo, Wo, Wo, Wo, Wo, Wo, Wo, Wo, Wo, Wo, Wo, Wo, Wo, Wo, Wo, Wo, Ww, Ww, Gs^Fds, Gg^Ve, Gg^Fet, Gs, Gg, Gs^Es, Re, Rp, Wwg, Gs^Efm, Gs^Efm, Hh, Hh^Es, Gs^Efm, Gs, Ds, Gs, Ds^Eff, Gs^Vl, Rb^Gvs, Rb^Gvs, Rb^Gvs, Ds^Gvs, Gll^Feth, Gs^Eff, Gs^Eff, Ds, Ww, Ww, Wo, Wwf, Wwf, Ww, Wo, Ww, Ww
Wo, Ss^Emf, Ss^Em, Sm, Sm^Edb, Ss^Edb, Ss^Em, Gll^Fmw, Gll^Fmw, Ss^Em, Ss^Emf, Rb^Fdw, Rb^Fdw, Gll^Fmw, Rb^Fdw, Ww, Ww, Wo, Wo, Wo, Wo, Wo, Wo, Wo, Wo, Wo, Wo, Wo, Wo, Wo, Wo, Wo, Wo, Wo, Wo, Wo, Wo, Wo, Wo, Ww, Ww, Gs^Fds, Gs^Fds, Gg, Hh, Hh^Edt, Hh, Gs, Rb, Hh, Hh, Hh, Gg, Hh^Fetd, Gs, Gs^Efm, Rp, Wwr, Rp, Gg^Eff, Gg^Eff, Rb^Gvs, Rb^Gvs, Rb^Gvs, Rb^Gvs, Rb^Gvs, Gd^Eff, Ds^Eff, Ww, Wo, Ww, Gg^Ebn, Sm, Ww, Wo, Wo, Wo^Ebn
Wo, Ss^Em, Ss^Edb, Sm, Ss, Rb, 6 Rb, Rb^Fdw, Ss, Ss^Tf, Ss^Em, Ss^Em, Gll^Fmw, Gll^Fp, Gll^Fmw, Gll^Fmw, Ww, Ww, Ss, Wo, Wo, Wo, Wo, Wo, Wo, Wo, Wo, Wo, Wo, Wo, Wo, Wo, Wo, Wo, Wo, Wo, Wo, Wo, Wo, Wo, Wo, Wwr, Ww, Hh^Fds, Ww, Gs, Ds, Hh, Hh^Fds, Rb, Rp, Rp, Rp, Rp, Re, Re, Gg, Rp^Es, Ds^Es, Rp, Gg, Gg^Eff, Gg^Eff, Rb^Gvs, Gg, Gd^Eff, Ds, Ww, Wo, Wo, Ww^Ewl, Sm, Gs, Co, Gg, Ww, Ww
Wo, Gll^Fmw, Sm, Ss, Hhd, Hhd^Em, Sm^Emf, Sm, Rb^Fdw, Ss^Em, Rb^Fdw, Gll^Fdw, Gll^Fmw, Gll^Fmw, Gll^Fp, Gll^Fmw, Gll^Fmw, Ss, Ss, Wo, Wo, Wo, Wo, Wo, Wo, Wo, Wo, Wo, Wo, Wo, Wo, Wo, Wo, Wo, Wo, Wo, Wo, Wo, Wo, Wo, Wo, Ww, Ww, Ww, Ww, Ww, Gs^Fds, Gs^Fds, Gs^Fds, Hh^Fds, Gs^Fds, Gs^Fds, Gs^Fds, Gg, Gg, Co, Co, Gg, Gg, Rp, Gg^Edt, Gg, Gg, Gd, Gd, Hh, Hh, Ww, Wo, Ww, Hh, Sm, Gs, Gs, Gs, Gd, Gd
Rb, Rb^Fdw, Gll^Fmw, Sm, Gd^Fmw, Re, Sm^Em, Sm^Em, Rb^Fdw, Wwg, Sm, Rb^Fmw, Gll^Fdw, Gll^Em, Ss, Ss, Gll^Fp, Ss, Ww, Ww, Ww, Wo, Wo, Wo, Wo, Wo, Wo, Wo, Wo, Wo, Wo, Wo, Wo, Wo, Wo, Wo, Wo, Wo, Wo, Wo, Wo, Wo, Wo, Wo, Wo, Ww, Wwr, Gs^Fds, Hh^Fds, Gs^Fds, Gs^Fds, Gs^Fds, Hh^Fds, Gs^Fds, Gg, Gd, 4 Ko, Gd^Vo, Re, Rb, Gg, Gg^Edt, Gg, Gd^Es, Gd, Gd, Ww, Ww, Hh, Ww, Hh, Hh, Hh, Gs, Hh, Gs^Es, Gs^Es
Gd, Ss, Gll^Fmw, Gll^Fdw, Gll^Fdw, Gd^Fdw, Hhd, Gll^Fdw, Hhd, Gll^Fdw, Gll^Fdw, Ss^Edb, Gll^Fdw, Gll^Fdw, Gll^Fdw, Ss, Ss, Ss, Ss, Ww, Ww, Ww, Ww, Wo, Wo, Wo, Wo, Wo, Wo, Wo, Wo, Wo, Wo, Wo, Wo, Wo, Wo, Wo, Wo, Wo, Wo, Wo, Wo, Wo, Wo, Wo, Ww, Ww, Hh, Hh^Fds, Hh^Fds, Hh^Fds, Hh^Fds, Hh^Fds, Hh^Emf, Hh, Gd, Co, Gg, Rb, Gg, Gd^Vo, Qxu, Gd, Hh, Gg, Ww, Hh, Wog, Ww, Gs, Hh, Hh, Hh, Hh, Hh, Hh
Gll^Fdw, Gll^Fdw, Gll^Fmw, Gll^Fdw, Gll^Fmw, Gll^Fdw, Hhd, Gll^Fdw, Rb, Rb, Gll^Fdw, Gll^Fdw, Rb, Gll^Fdw, Ss, Ss, Ss, Ss, Gs, Ss, Gs, Gs, Gs, Ww, Ww, Wo, Wo, Wo, Wo, Wo, Wo, Wo, Wo, Wo, Wo, Wo, Wo, Wo, Wo, Wo, Wo, Wo, Wo, Wo, Wo, Wo, Wo, Ww, Ww, Gg, Gs^Fds, Hh^Fds, Hh^Fds, Hh^Fds, Hh^Fds, Hh^Fds, Gs^Fds, Gd, Gs^Fds, Rp, Rp, Gg, Kte, Qxu, Hh, Hh, Ww, Wog, Ww, Ww, Ww, Gs^Es, Gs, Hh, Hh^Edt, Hh, Hh
Gll^Fdw, Rb, Gll^Fdw, Gll^Fdw, Gll^Fdw, Gll^Fdw, Gll^Fmw, Gll^Fdw, Gll^Fdw, Ss, Gll^Fdw, Gll^Fdw, Gs, Ss, Ss, Ss, Gs, Gs, Gs, Gs, Gs, Gs, Gs, Gs, Gs, Ww, Wo, Wo, Wo, Wo, Wo, Wo, Wo, Wo, Wo, Wo, Wo, Wo, Wo, Wo, Wo, Wo, Wo, Wo, Wo, Wo, Wo, Wo, Wo, Ww, Ww, Gs^Fds, Gs^Fds, Hh^Fds, Gs^Fds, Hh^Fds, Gs^Fds, Gs^Fds, Gs^Fds, Gs^Fds, Gg^Edt, Rp, Hh, Hh, Hh, Hh, Ww, Wog, Chw, Ww, Gg^Efm, Gs^Efm, Hh, Gs, Hh, Hh^Vhh, Rp
Gll^Fdw, Sm, Hhd, Hhd, Hhd, Ss, Hhd, Gll^Fdw, Gs^Fds, Gll^Fdw, Gs^Fds, Gs, Gs, Gs, Ss, Gs, Gs, Gs, Gs, Gs, Gs, Gs, Gs, Gs, Gs, Ww, Ww, Wo, Wo, Wo, Wo, Wo, Wo, Wo, Wo, Wo, Wo, Wo, Wo, Wo, Wo, Wo, Wo, Wo, Wo, Wo, Wo, Wo, Wo, Wo, Wo, Ww, Wo, Ww, Ww, Ww, Ww, Gs^Fds, Gs^Fds, Gs^Fds, Gg, Re, Hh, Hh, Hh, Hh^Vhh, Ww, Ww, Ww^Bsb|, Gg, Gg^Es, Gg, Hh, Hh, Rp, Rp, Ww
Gll^Fdw, Gll^Fdw, Gll^Fmw, Gll^Fdw, Gll^Fmw, Gll^Fmw, Hhd, Gs^Fds, Hhd^Fds, Gs^Fds, Gs^Fds, Gs^Fds, Gs^Fds, Gs, Ss, Ss, Gs, Gs, Gs, Gs, Gs, Gs, Gs, Gs, Re, Re, Ch, Ww, Ww, Wo, Wo, Wo, Wo, Wo, Wo, Wo, Wo, Wo, Wo, Wo, Wo, Wo, Wo, Wo, Wo, Wo, Wo, Wo, Wo, Wo, Wo, Wo, Wo, Wo, Wo, Ww, Wo, Ww, Wwr, Gg^Emf, Rp, Re, Rp, Hh^Emf, Rp, Gg^Dr, Ww, Ww, Khw, Ww, Gg, Hh, Hh, Hh^Edb, Rp, Ww, Ww
Gll^Fdw, Rb, Sm, Gll^Fmw, Gs, Gll^Fmw, Gll^Fdw, Hhd^Fds, Gs^Fds, Hhd^Fds, Gs^Fds, Gs^Fds, Ss, Ss, Ss, Gs, Gs, Gs, Gs, Gs, Re, Re, Re, Gs^Vh, Re, Gd, Kh, Ch, Re, Ww, Wo, Wo, Wo, Wo, Wo, Wo, Wo, Wo, Wo, Wo, Wo, Wo, Wo, Wo, Wo, Wo, Wo, Wo, Wo, Wo, Wo, Wo, Wo, Wo, Wo, Wo, Wwr, Wo, Ww, Ww, Ww, Ww, Ww, Rp, Rp, Re, Rp, Ww^Bsb/, Ww, Ww^Bsb\, Rp, Hh, Rp, Rp, Ww, Ww, Wo
Sm, Sm, Gll^Fmw, Gll^Fmw, Gll^Fdf, Gll^Fdw, Gll^Fdw, Gll^Fdw, Hhd, Hhd^Fds, Hh^Fds, Hh^Fds, Gs, Ss, Re^Gvs, Re^Gvs, Re^Gvs, Gs, Gs, Gs^Vh, Re, Gs^Vh, Gs, Re, Re, Ch, Ch, Ch, Gd, Ww, Ww, Wo, Ww, Wo, Ww, Wo, Wo, Wo, Wo, Wo, Wo, Wo, Wo, Wo, Wo, Wo, Wo, Wo, Wo, Wo, Wo, Wo, Wo, Wo, Wo, Wo, Wo, Wo, Wo, Ww, Ww, Ww, Ww, Ww, Ww, Ww, Ww, Ww, Ww, Ww, Ww, Rp, Wwr, Ww, Ww, Ww, Wo
Rb, Rb, Gll^Fmw, Gll^Fmw, Sm, Rb, Gll^Fmw, Gll^Fdw, Hh, Hh^Fds, Hh, Hh^Fds, Gs, Gs, Gs^Fds, Re^Gvs, Gs, Gs, Re, Re, Gs^Wm, Gs, Gs, Gs, Rrc, Rrc, Gd, Rrc, Rrc, Gd, Gd, Ww, Ww, Ww, Ww, Wo, Ww, Wo, Wo, Wo, Wo, Wo, Wo, Wo, Wo, Wo, Wo, Wo, Wo, Wo, Wo, Wo, Wo, Wo, Wo, Wo, Wo, Wo, Wo, Wo, Wo, Wo, Wo, Wo, Wo, Ww, Wo, Wo, Wo, Ww, Ww, Ww, Ww, Ww, Wo, Wo, Ww
Sm, Sm, Sm, Sm, Gs, Gll^Fmw, Gd, Hh, Hh, Hh, Gd, Gs, Gs, Gs^Fds, Gs^Fds, Gs^Fds, Gs, Gs, Gd^Vh, Re, Rrc, Rrc, Rrc, Rrc, Gd, Gd, Gd, Gd, Gd, Rrc, Rrc, Gd, Gs, Gs, Gs, Ww, Gs, Ww, Wo, Wo, Wo, Wo, Wo, Wo, Wo, Wo, Wo, Wo, Wo, Wo, Wo, Wo, Wo, Wo, Wo, Wo, Wo, Wo, Wo, Wo, Wo, Wo, Wo, Wo, Wo, Wo, Wo, Wo, Wo, Wo, Wo, Ww, Wo, Wo, Wo, Wo, Ww
Gg, Sm, Gs, Rb, Gd, Gs, Rrc, Gd, Gd, Hh, Gs, Gs, Gs, Gs, Re^Gvs, Re^Gvs, Re^Gvs, Gs, Rrc, Rrc, Gd, Gd^Vh, Gd, Gd, Gd, Gd, Gd, Gd, Gd, Gd, Gd, Rrc, Rrc, Gs, Gs, Gs, Gs, Ww, Ww, Wo, Wo, Wo, Wo, Wo, Wo, Wo, Wo, Wo, Wo, Wo, Wo, Wo, Wo, Wo, Wo, Wo, Wo, Wo, Wo, Wo, Wo, Wo, Wo, Wo, Wo, Wo, Wo, Wo, Wo, Wo, Wo, Wo, Wo, Wo, Wo, Wo, Wo
Rrc, Gs, Rrc, Gs, Rrc, Rrc, Gs^Fds, Rrc, Rrc, Rrc, Rrc, Rrc, Rrc, Re^Gvs, Re^Gvs, Re^Gvs, Rrc, Rrc, Gd, Gd, Gd, Gd, Gd, Gd, Gd, Gd, Gd, Gd, Gd, Gd, Gd, Rrc, Rrc, Gs, Gs, Gs, Gs, Ww, Ww, Wo, Ww, Wo, Wo, Wo, Wo, Wo, Wo, Wo, Wo, Wo, Wo, Wo, Wo, Wo, Wo, Wo, Wo, Wo, Wo, Wo, Wo, Wo, Wo, Wo, Wo, Wo, Wo, Wo, Wo, Wo, Wo, Wo, Wo, Wo, Wo, Wo, Wo
Gg, Rrc, Gd, Rrc, Gs^Fds, Gs^Fds, Gs, Gs, Gs, Gs^Fds, Gs^Fds, Gs^Fds, Gd^Fds, Rrc, Rrc, Rrc, Gd, Gd, Gd, Gd, Gd, Gd, Gd, Gd, Gd, Gd, Gd, Gd, Gd, Gd, Gs, Gs, Gs, Rrc, Rrc, Gs, Gs, Gs, Gs, Ww, Ww, Ww, Wo, Wo, Wo, Wo, Wo, Wo, Wo, Wo, Wo, Wo, Wo, Wo, Wo, Wo, Wo, Wo, Wo, Wo, Wo, Wo, Wo, Wo, Wo, Wo, Wo, Wo, Wo, Wo, Wo, Wo, Wo, Wo, Wo, Wo, Wo
Gs^Fds, Gs^Fds, Gs^Fds, Gs^Fds, Gs^Fds, Gs^Fds, Gs^Fds, Gs^Fds, Gs^Fds, Gs^Fds, Gs^Fds, Gs^Fds, Gs, Gs, Gs, Gs, Gd, Gd, Gd, Gd, Gd, Gd, Gd, Gd, Gd, Gd, Gd, Gd, Gs, Gs, Gs, Gs, Gs, Gs, Gs, Rrc, Rrc, Gs, Gs, Gs, Gs, Ww, Ww, Wo, Wo, Wo, Wo, Wo, Wo, Wo, Wo, Wo, Wo, Wo, Wo, Wo, Wo, Wo, Wo, Wo, Wo, Wo, Wo, Wo, Wo, Wo, Wo, Wo, Wo, Wo, Wo, Wo, Wo, Wo, Wo, Wo, Wo
Gs^Fds, Gs^Fds, Gd, Gs^Fds, Gs^Fds, Gs^Fds, Gs^Fds, Gs^Fds, Gg, Gg, Gg, Gg, Gg, Gs, Gs, Gs, Gs, Gd, Gd, Gd, Gd, Gd, Gd, Gd, Gd, Gd, Gs, Gs, Gs, Gs, Gs, Gs, Gs, Gs, Gs, Gs, Gs, Rrc, Rrc, Gs, Gs, Gs, Ww, Wo, Wo, Wo, Wo, Wo, Wo, Wo, Wo, Wo, Wo, Wo, Wo, Wo, Wo, Wo, Wo, Wo, Wo, Wo, Wo, Wo, Wo, Wo, Wo, Wo, Wo, Wo, Wo, Wo, Wo, Wo, Wo, Wo, Wo
