Wo, Wo, Wo, Wo, Wo, Wo, Dd, Ww, Dd^Dc, Wwt, Ww, Wo, Wo, Wo, Wo, Wo, Wo, Wo, Wo, Ww, Wo, Ww, Wo, Wo, Wo, Wo, Wo, Ww, Ds, Ds^Fp, Re, Mm, Mm, Mm, Md, Hh^Fp, Rr, Hh^Fp, Hh^Fp, Gd, Md, Md, Mm^Xm, Mm, Mm^Xm, Mm, Mm^Xm, Mm, Mm^Xm, Mm, Md^Xm, Md^Xm, Md^Xm, Md^Xm, Md^Xm, Mm, Mm, Mm, Hh, Hh, Hh, Mm, Gd, Gd, Gd, Gd, Gll, Rp, Rp, Gd, Gd, Gd, Gd, Gd, Gd, Gd, Ss
Wo, Wo, Wo, Wo, Wo, Ww, Ww, Dd, Wo, Dd, Dd^Vda, Ww, Ww, Wo, Wo, Wo, Wo, Wo, Wo, Wo, Wo, Wo, Wo, Wo, Wo, Wo, Wo, Ww, Ds, Gd^Fp, Re, Gg^Fp, Ww, Md, Md, Hh^Fp, Rr, Hh^Fp, Md, Md, Uu, Md, Mm^Xm, Mm^Xm, Uh, Md^Xm, Md^Xm, Md^Xm, Md^Xm, Md^Xm, Md^Xm, Md^Xm, Md^Xm, Mm, Mm, Mm, Hh^Vhh, Mm, Ce, Hh, Ce, Gll, Ce, Ce, Ce, Gd, Ce, Gd, Rp, Rp, Gd, Gs, Gs^Tf, Gd, Ss, Ss, Ss
Wo, Wo, Wo, Wo, Wo, Wo, Wo, Ww, Ww, Ww, Ww, Ww, Ww, Ww, Ww, Wo, Ww^Vm, Wo, Wo, Wo, Wo, Wo, Wo, Wo, Wo, Wo, Ww, Ww, Ww, Gd^Fp, Re, Ww, Re^Fp, Md, Ww, Rr, Hh^Vhhr, Hh^Fp, Cf, Uu, Md^Xm, Uu, Uh, Uh, Mm^Xm, Uu, Ur, Md^Xm, Md^Xm, Md^Xm, Mm, Mm, Mm, Mm, Wwg, Mm, Wwg^Bw|r, Mm, Wwg, Ce, Rp^Vct, Ce, Cer, 3 Ke, Ce, Ce, Rp, Rp, Gd^Tf, Gd, Gd, Gd^Tf, Ss, Ss, Ss, Ss, Ss
Wo, Wo, Wo, Wo, Wo, Wo, Wo, Ww, Wwr, Ww, Dd, Dd, Ww, Ww, Mm, Ww, Ww, Wo, Wo, Wo, Wo, Wo, Wo, Wo, Ww, Ww, Ww, Chr, Re, Ww^Bw/, Ds, Gg^Fp, Ww, Ww, Hh^Fp, Rr, Mm, Hh^Fp, Cf, Md, Mm, Md, Mm, Mm^Xm, Mm^Xm, Mm^Xm, Uue, Md^Xm, Mm, Mm, Re, Mm, Gs^Eff, Gd^Eff, Gd^Eff, Wwg, Gs, Wwg, Chw, Ww^Ewl, Rp, Re, Re^Vct, Ce, Cer, Rp, Gs, Gd, Wwg, Ds, Wwg, Gs, Wwg, Wwg, Wwg, Ss, Ss
Wwt, Ww^Vm, Wwr, Wo, Wo, Wo, Ww, Wwr, Wwr, Wwr, Gs^Ft, Gs^Ft, Gs^Ft, Ww, Ds, Ds, Ww, Wo, Wo, Wo, Wwg, Wo, Wo, Wo, Ww, Ww, Chr, Chr, Re, Ww, Ww, Gs^Fp, Ww, Ds, Cfr, Rb, Cfr, Hh^Fp, Cfr, Hh^Fp, Mm, Hh, Mm, Mm^Xm, Mm^Xm, Mm, Uu^Vu, Uu, Re, Re, Re^Vwm, Gs, Rb^Gvs, Rb^Gvs, Rb^Gvs, Gs, Gs, Wwf, Wwg, Wwg^Bw\r, Rp, Gd, Cer, Cer, Gs, Wwg, Ds, Wwg^Bw\r, Wwg, Wwg, Ss, Wwg, Wwg, Wwg, Ss, Gll^Fdw, Ss
Wo, Wwr, Wwr, Wo, Wo, Wo, Wo, Ww, Ww, Dd, Dd, Wwg, Ds, Ds, Ds, Chw, Ww, Wo, Wwrg, Wwg, Wo, Ww^Ewl, Wwr, Ww, Mm, Ww, Wwf, Gs^Fp, Re^Vc, Re, Ww^Bsb\, Ww, Gll^Fp, Qxu, Gll^Fp, Rp, Hh^Fp, Rp, Cf, Kfr, Hh, Hh, Mm, Mm^Xm, Cte, Cte, Uhe, Uue, Mm, Sm, Hh, Rb^Gvs, Rb^Gvs, Rb^Gvs, Gs^Eff, Gs^Fetd, Rp, Rp, Ce, Wwg, Wwg, Wwf, Wwg^Bw|r, Gs, Wwg, Ds, Wwg, Wwg, Wo, Wwr, Wwr, Ss, Ss, Ss, Ss, Ss, Ss
Wo, Wo, Wo, Wo, Wo, Wo, Wo, Wo, Wo, Ww, Ww, Dd, Chw, Ds, Chw, 5 Km, Ww, Wwrg, Wwrg, Ww, Ww, Ww, Wwrg, Ww, Ww, Wwf, Wwf, Re, Gd, Ww, Ww, Re, Re, Gll^Fp, Rp, Rb, Cud, Hh^Fp, Mm, Hh, Gs, Mm, Mm^Xm, Mm^Xm, Md^Xm, Uu, Md^Xm, Md^Xm, Md^Xm, Hh, Hh, Gs^Eff, Gs^Eff, Gs^Eff, Re^Vct, Rp, Re, Ce, Wwg, Wwg, Wwg, Wwg, Wog, Wog, Wog, Wog, Wog, Wo, Wog, Wwg, Ss^Tf, Gll^Feth, Ss, Ss, Ss, Gll^Fdw, Ss
Wo, Wo, Wo, Wo, Wo, Wo, Wo, Wo, Wo, Ww^Vm, Wo, Chw, Wwr, Chw, Ww, Ww, Wo, Wo, Wo, Wwg, Wwf, Ww, Wo, Wwrg, Wwf, Ww, Ww, Ds, Mm, Mm, Ww, Ds, Gd^Fp, Rp, Hh^Fp, Cud, Hh^Fp, Hh^Fp, Hh^Fp, Gs, Mm, Hh, Mm, Mm^Xm, Md^Xm, Ur, Ur, Md^Xm, Md^Xm, Mm, Mm, Hh, Hh, Gs, Mm, Rp, Sm, Ce, Ce, Wwg, Ds, Wog, Wog, Wog, Cer, Ww^Ewl, Wwf, Ss, Ss, Wog, Wwrg, Ss, Ss, Gd^Fetd, Ss, Ss, Ss
Wo, Wo, Wo, Wo, Wo, Wo, Wo, Wo, Wo, Wo, Wo, Wo, Ww, Wwr, Ww, Wwr, Wo, Wo, Wwg, Wwf, Cme, Cme, Ww, Ww^Ewl, Wwg, Wwg, Ww, Ds, Mm, Ww^Vm, Ww, Ww, Gg^Fp, Rp, Rp, Hh^Fp, Ww, Gd^Esd, Ww, Gs, Ds, Hh^Vhh, Mm, Mm^Xm, Mm, Mm, Gs, Md^Xm, Md^Xm, Mm, Hh, Hh, Mm, Hh, Hh, Gg^Edt, Sm^Bw|r, Gd, Gll^Fdw, Ss, Gd, Gd, Gd^Tf, Ds, Wog, Wwf, Ss, Wwg, Wwrg, Wwr, Wog, Wog, Wwg, Sm, Sm, Ss, Ss
Wo, Wo, Wo, Wo, Wo, Wo, Wo, Wo, Wo, Wo, Ww, Ww^Vm, Ww, Ww, Wo, Wo, Wo, Cme, Cme, Wwf, Ww^Ewf, Sm, Ww^Ewl, Ww, Wwg, Ww, Wwr, Ww, Ww, Ww, Ww, Ww, Ww^Ewf, Gg^Fp, Ww^Bsb|, Ww, Wo, Wo, Wwg, Wwg, Wo, Ds, Mm^Xm, Mm^Xm, Mm, Gs^Ecf, Ce, Md^Xm, Md^Xm, Wo, Qxu, Hh^Vhh, Hh, Mm, Mm, Ww^Ewf, Rp, Mm, Gll^Fdw, Gd^Fdw, Gd, Gd, Gg, Ss^Tf, Wog, Ss, Wwg, Wwf, Wwr, Wwrg, Wwg, Wog, Wwg, Tb, Tb, Sm, Ss
Wo, Wo, Wo, Wo, Wo, Wo, Wo, Wo, Wo, Wo, Wo, Ww, Wwg, Ww, Wwg, Wo, Wwg, Wwg, Sm, Kme, Ww^Ewl, Wwg, Wwg, Wwg, Wwg, Ww, Wo, Wo, Wo, Ww, Wo, Ww, Wo, Ww, Wo^Bsb|, Wo, Ww, Ww, Gs^Fds, Wo, Ww, Wo, Wwr, Mm, Gg, Khr, Re, Hh^Vhh, Mm, Mm, Hh, Qxu, Qxu, Hh, Hh, Gs, Gs^Fdw, Rb, Gd^Fdw, Gd^Fdw, Gg, Gd, Ss, Ss, Ww^Ewl, Wwg, Wwg, Ss, Wog, Gd, Gg, Wog, Ss^Vhs, Ss, Mm, Mm, Ss
Wo, Wo, Wo, Wo, Wo, Wo, Wo, Wo, Wo, Wo, Wo, Sm, Wwg, Ww^Ewl, Wwg, Sm, Sm, Sm, Wwg, Sm, Ww, Ww^Ewl, Wwg, Wo, Wo, Wo, Wo, Wo, Ww, Ww, Ww, Ww, Ww, Ww, Re, Ww, Ww, Ww^Ewf, Gs^Fds, Ww, Wo, Wo, Ww, Ds, Ds, Gg, Re, Gs, Gs, Mm, Gg, Hh, Hh, Hh, Hh, Hh^Fdw, Gs, Gd, Rp, Ss, Sm, Ss, Wog, Wog, Ss, Ss, Wwg, Wog, Wog, Ss, Wog, Gg^Tf, Ss^Tf, Sm, Sm, Sm, Gg^Es
Wo, Wo, Wo, Wo, Wo, Wo, Wo, Wo, Wo, Wo, Wwg, Ww, Wwg, Sm, Sm, Wwg, Wwf, Wwf, Wwg, Chs, Wwg, Wwg, Wwf, Wo, Wo^Xo, Wo, Wo, Wo, Wo, Ww^Ewf, Ww, Wo, Gs^Fet, Gs^Fds, Gs^Fds, Gs^Fds, Gs^Fds, Gs^Fds, Gs^Fds, Ds, Ww, Wo, Wo, Ww, Wo, Wwf, Ww^Ewl, Re, Re, Gs^Efm, Gs^Efm, Gs^Es, Gg, Khr, Qxu, Rb^Dr, Dd^Dc, Gs, Rb, Ss, Ww^Wkf, Sm, Ww^Ewl, Wwf, Sm, Wwg, Ww^Ewl, Wwg, Wwg, Wog, Wog, Wog, Sm, Ss, Ss, Sm, Sm
Ww, Ww, Ww, Wo, Ww, Ww, Ww, Wo, Gll^Fdw, Wwg, Wwg, Ww, Wwf, Wwf, Sm, Ww^Ewl, Wwf, Ww^Ewl, Ww, Sm, Wwg, Wwf, Wo, Wo, Wo^Xo, Wo, Wo, Wo, Ww, Wo, Ww, Wo, Gs^Fds, Rb, Re, Gs^Fds, Gs^Ve, Gs^Fds, Gs^Fds, Gs^Fds, Gg^Fet, Cme, Hh^Fds, Wwr, Wwf, Ww, Wwf, Ds^Ewsh, Re, Gs, Re, Gs, Gs, Gs, Hh, Qxu, Hh, Cer, Hh, Wog^Bw\, Rp, Wog, Gg, Sm, Chs, Wwg, Wwg, Ww, Wwg, Wwg, Gs^Eff, Sm, Rb^Gvs, Gg^Tf, Gs^Vl, Ss, Sm
Ww, Ww, Ww, Ww, Ww, Ww, Ww, Ww, Gll^Fdw, Wwg, Chs, Wwg, Wwf, Ww, Ss, Gll^Fmw, Wwg^Bw\r, Ww, Ww, Ww, Wo, Wo, Wo, Wo, Wo^Xo, Wo, Wo, Wo, Ww, Wwr, Ww, Ww, Gs^Fds, Gs^Fds, Gs^Fds, Re, Re, Gs^Fds, Gs^Fds, Gs^Fds, Gs^Fds, Re, Wwf, Ww, Wwf, Ww, Ds, Gs^Edb, Re, Rr, Hh, Hh^Vc, Gg, Gg, Gg^Esd, Qxu, Gg, Hh, Gs^Vc, Hh, Rp, Gg, Rp, Rp, Rp, Wwg, Wwg, Wwg, Hh^Eff, Hh^Eff, Rb^Gvs, Wog, Rb^Gvs, Rb^Gvs, Rb^Gvs, Rb, Ss
Gll^Fdw, Ww, Gll^Fdw, Ww, Ww, Ww, Ww, Wwg, Wwg, Wwg, Wwg, Ww, Ww, Ww, Ww, Ww, Ww, Ss, Wo, Chw, Wo, Wo, Wo, Wo, Wo^Xo, Wo, Ww, Ww, Ds, Gs^Fds, Gs^Fds, Gs^Fds, Gs^Fds, Gs^Fds, Re, Re, Mm, Re, Gs^Fds, Re, Hh^Fds, Hh, Ds, Ww, Ww, Chw, Re, Re, Hh, Hh, Ww^Ewf, Rp, Hh, Hh, Rp, Gg, Rp, Gg, Rp, Hh, Rp, Re, Wwg, Wwg, Wwg, Wwg^Bw\, Rp, Hh, Mm, Hh^Eff, Gs^Eff, Rb^Gvs, Rb^Gvs, Rb^Gvs, Ss, Ss, Ce
Gll^Fdw, Gll^Fdw, Gll^Fmw, Gll^Fdw, Gll^Fdw, Ww, Ww, Wwg, Gll^Fmw, Wwrg, Wwg, Ss, Wwg, Wwrg, Sm, Sm, Wo, Wo, Wo, Wo, Wo, Wo, Wo, Wo, Wo^Xo, Wo, Ww, Ds, Ds, Gs^Fds, Gs^Fds, Gs^Fds, Gs^Fds, Gs^Fds, Gs^Fds, Gs^Fds, Hh^Fds, Hh^Fds, Mm, Hh, Hh^Fds, Hh^Fds, Ww, Wo, Wo, Ww, Wo, Wo, Wo, Ww, Ww, Hh, Hh, Hh, Qxu, Rp, Wog, Rp, Ww, Re, Ww, Wwg, Ww, Wwg, Chw, Wwg, Re, Rp, Rp^Es, Mm, Rp, Gs^Eff, Gg^Eff, Gs^Eff, Gg, Ss, Ce
Gll^Fdw, Gll^Fdw, Gll^Fdw, Gll^Fmw, Gll^Fdw, Hhd, Ww, Ww, Gll^Fdw, Wwg, Wwg, Wwg, Gll^Fmw, Wwg, Gll^Fmw, Wo, Rb^Fdw, Wo, Wo, Wo, Wo, Wo, Wo, Wo, Wo^Xo, Wo, Wo, Ww, Ww, Wwr, Gs^Fds, Gs^Fds, Re, Re, Cv, Gs^Fds, Gs^Fds, Mm, Hh^Fds, Gs^Fet, Mm, Hh^Fds, Gs^Fds, Ww, Ss^Vhs, Ds^Ewsh, Ww^Wkf, Ww, Ww, Wo, Wo, Ww, Ww, Chw, Wwg, Gs^Fetd, Wwg, Wog, Wog, Ww, Ww, Ww, Ww, Ww, Ww, Wwrt, Gg^Edb, Gg, Gg^Em, Rb, Rp, Hh, Re, Gg^Edt, Rp, Re^Vct, Rp
Qxu, Ss, Gll^Fmw, Gll^Fmw, Gll^Fmw, Hhd, Sm, Ww, Gll^Fmw, Wwg, Sm, Ss, Wwg, Wwg, Gll^Fp, Wwrg, Wwrg, Wo, Wo, Wo, Wo, Wo, Wo, Wo, Wo^Xo, Wo, Wo, Ww^Ewl, Ww, Ww, Gs^Fds, Gs^Fds, Gg^Ve, Cv, 2 Kv, Cv, Cv, Gs^Fds, Re, Gs^Fds, Re, Gs^Fds, Ds, Re, Re, Ss, Gs^Efm, Gs^Efm, Gs^Efm, Ww, Ww, Wo, Wo, Wwg, Wwf, Wwg, Wog, Wwg, Wog, Ww, Ww, Ww, Wo, Ww, Wwf, Wwf, Ww, Gg, Ke, Ce^Es, Gg, Hh, Gg, Rp, Ai, Rp, Gg
Qxu, Gll^Fdw, Gll^Fmw, Rb, Rb^Fdw, Gll^Fmw, Rb^Fdw, Rb^Fdw, Gll^Fdw, Gll^Fdw, Gll^Fdw, Gll^Fdw, Gll^Fdw, Wwg, Wwg, Wo, Wo, Wo, Wo, Wo, Wo, Wo, Wo, Wo, Wo^Xo, Wo, Wo, Wo, Ww^Ewl, Ww, Gs^Fds, Gs^Fds, Gs^Fds, Cv, Cv, Cv, Gs^Ve, Re, Gs^Fds, Re, Gs^Fds, Gs^Fds, Ww, Gs^Fds, Ww, Gs^Efm, Wwrg, Ww, Ww, Ww, Ww, Ww, Wo, Wo, Wo, Wwf, Wwg, Wog, Wog, Ww, Wo, Wo, Ww, Wwf, Wwf, Ww, Wo, Ww, Wwf, Ce, Ce, Ce, Ce, Gd, Gd, Sm, Ss
Qxu, Qxu, Sm, Gll^Fdw, Gll^Fdw, Gll^Fp, Gll^Fdw, Ss^Em, Gll^Fdw, Gll^Fp, Ww, Ww, Ww, Ww, Ww, Wo, Wo, Wo, Wo, Wo, Wo, Wo, Wo, Wo, Wo^Xo, Wo, Wo, Wo, Ww, Wwr, Ds, Gs^Fds, Gs^Fds, Cv, Gs^Fds, Gs^Fds, Ds, Gs^Fds, Ww, Ww^Esd, Wo, Ww, Wo, Ww, Wo, Ww, Ww^Ewf, Ww, Wwrg, Wo, Wo, Wo, Ww, Ww, Ww, Wwg^Wkf, Wwg^Wkf, Wwg, Ww, Ww, Ww^Ewl, Wo, Ww, Wwf, Gg^Em, Ww, Wo, Wwf, Wwf, Cer, Chw, Ce, Ce, Gs, Gg, Sm, Sm
Wo, Sm, Gll^Fdw, Ss, Qxu, Gll^Fdw, Rb, Gll^Fdw, Gll^Fp, Rb, Rb^Fdw, Ww, Ww, Ww, Ww, Wo, Wo, Wo, Wo, Wo, Wo, Wo, Wo, Wo, Wo^Xo, Wo, Wo, Wo, Wo, Ww, Ww, Gs^Fds, Gs^Fds, Gs^Fds, Gs^Fds, Wwr, Ww, Ww, Wo, Wo, Ww, Wo, Ww, Wo, Ww^Ewl, Wo, Ww, Ww^Bw\r, Re, Ww, Wwg, Wwg, Gg, Gg^Efm, Gs^Dr, Gs^Dr, Gs^Fp, Ww^Ewf, Ww, Ww, Ww^Ewl, Wo, Ai, Ds^Em, Gg, Ai, Wwr, Wwf, Ww, Ww, Wwf, Wo, Wo, 1 Ke, Ww, Gg, Ww
Wo, Rb, Hhd, Gll^Fdw, Rb, Qxu, Hhd, Gll^Fdw, Gll^Fp, Gll^Fmw, Ss^Em, Rb^Fdw, Gll^Fp, Ww, Ww, Ww, Wo, Wo, Wo, Wo, Wo, Wo, Wo, Wo, Wo^Xo, Wo, Wo, Wo, Wo, Ww^Ewl, Gs^Fds, Gs^Fds, Gs^Fds, Gs^Fds, Rb, Ww, Ww, Ww^Ewf, Wwf, Ww^Ewl, Ww, Ww, Gg, Ww, Gs, Ww, Ds, Re, Gs, Chw, Ww, Gg^Ecf, Gs^Efm, Gs^Efm, Gs, Gs^Fp, Gs^Fp, Wwr, Wwg, Ai, Gs^Eff, Gs^Eff, Rb^Gvs, Ds^Eff, Gs^Eff, Ww^Bw\r, Ww, Wwrg, Wo, Ww, Ww, Wwf, Wwf, Wo, Wo, Ww, Wo
Wo, Hhd, Hhd^Fmw, Rb^Fdw, Sm^Edb, Hhd^Fmw, Hhd^Emf, Hhd^Fp, Gll^Fdw, Gll^Fdw, Wwg, Gll^Fmw, Gll^Fmw, Gll^Fmw, Sm, Ww, Wo, Wo, Wo, Wo, Wo, Wo, Wo, Wo, Wo^Xo, Wo, Wo, Wo, Ww, Ww^Ewl, Gs^Em, Gs^Fds, Ww, Rb, Rb^Dr, Rb, Ww, Ww, Ww, Wwf, Ww, Gs^Fds, Gg^Ve, Gg^Fet, Gs, Gg, Gs^Es, Re, Rp, Wwg, Gs^Efm, Gs^Efm, Hh, Hh^Es, Gs^Efm, Gs, Ds, Gs^Fp, Ds, Gs^Vl, Gll^Feth, Ai, Rb^Gvs, Ds^Gvs, Gll^Feth, Gs^Eff, Gs^Eff, Wwf, Ww, Wo, Wo, Wwf, Wwf, Wot, Wo, Wo, Wo
Wo, Ss^Emf, Ss^Em, Sm, Sm^Edb, Ss^Edb, Ss^Em, Gll^Fmw, Gll^Fmw, Ss^Em, Ss^Emf, Rb^Fdw, Rb^Fdw, Gll^Fmw, Rb^Fdw, Ww, Ww, Wo, Wo, Wo, Wo, Wo, Wo, Wo, Wo^Xo, Wo, Wo, Wo, Ds^Ewsh, Gs^Fds, Gs^Fds, Gs^Fds, Gs^Fds, Wwr, Rb^Dr, Rb^Ecf, Ww, Wwr, Wwr, Ww, Ww, Gs^Fds, Gs^Fds, Gg, Hh, Hh^Edt, Hh, Gs, Rb, Hh, Hh, Hh, Gg, Hh^Fetd, Gs, Gs^Efm, Wwg^Bw/r, Rp, Wwg, Gll^Feth, Ss, Rb^Gvs, Gd^Fetd, Rb^Gvs, Rb^Gvs, Rb^Gvs, Gd^Eff, Ds^Eff, Ww, Wo, Ww, Gg^Ebn, Sm, Ww, Wot, Wo, Wo
Wo, Ss^Em, Ss^Edb, Sm, Ss, Rb, 6 Rb, Rb^Fdw, Ss, Ss^Tf, Ss^Em, Ss^Em, Gll^Fmw, Gll^Fp, Gll^Fmw, Gll^Fmw, Ww, Wo, Wo, Wo, Wo, Wo, Wo, Wo, Wo^Xo, Wo, Wo, Wo, Wo, Ds^Ewsh, Cme, Gs^Fds, Ww, Ww, Ww, Wwr, Wo, Wo, Wo, Wo, Wo, Wwr, Ww, Hh^Fds, Ww, Gs, Ds, Hh, Hh^Qhhf, Rb, Rp, Rp, Rp, Co, Co, Re, Wwg, Wwrg, Ss, Rp, Ss, Ker, Gg^Eff, Rb^Gvs, Gg^Eff, Gd^Eff, Ds, Ww, Wo, Wo, Ww^Ewl, Sm, Re, Co, Gg, Ww, Ww
Wo, Gll^Fmw, Sm, Ss, Hhd, Hhd^Em, Sm^Emf, Sm, Rb^Fdw, Ss^Em, Rb^Fdw, Gll^Fdw, Gll^Fmw, Gll^Fmw, Gll^Fp, Gll^Fmw, Ww, Wo, Wo, Wo, Wo, Wo, Wo, Wo, Wo^Xo, Wo, Wo, Wo, Wo, Ds^Ewsh, Wo, Ww, Wo, Wo, Wo, Wo, Wo, Wo, Wo, Wo, Wo, Ww, Ww, Ww, Ww, Ww, Ww, Gs^Fds, Gs^Qhhf, Hh^Qhhf, Gs^Fds, Gs^Qhhf, Gs^Qhhf, Gg, 4 Ko, Gg, Co, Wwg, Gs^Fp, Rp, Wwg, Sm, Cer, Gd^Eff, Gd^Tf, Hh^Tf, Hh, Ww, Wo, Ww, Re, Sm, Gs, Gs, Gs, Gd, Gd
Rb, Rb^Fdw, Gll^Fmw, Sm, Gd^Fmw, Re, Sm^Em, Sm^Em, Rb^Fdw, Wwg, Sm, Rb^Fmw, Gll^Fdw, Gll^Em, Ss, Ww, Gll^Fp, Wo, Wo, Wo, Wo, Wo, Wo, Wo, Wo^Xo, Wo, Wo, Wo, Wo, Wo, Wo, Wo, Wo, Wo, Wo, Wo, Wo, Wo, Wo, Wo, Wo, Wo, Wo, Wo, Wo, Ww, Wo, Ww, Ww, Kvr^Qhhf, Gs^Qhhf, Gs^Qhhf, Hh^Fds, Gs^Fds, Co, Gd, Gs, Gd^Vo, Sm, Rb, Uue^Emf, Wwg, Ss, Gd, Gd, Gd, Ww, Ww, Hh, Ww^Bw/r, Hh, Hh, Hh, Gs, Hh, Gs^Es, Gs^Es
Gd, Ss, Gll^Fmw, Gll^Fdw, Gll^Fdw, Gd^Fdw, Hhd, Gll^Fdw, Hhd, Gll^Fdw, Gll^Fdw, Ss^Edb, Gll^Fdw, Gll^Fdw, Gll^Fdw, Ww, Ww^Ewl, Wo, Wo, Wo, Wo, Wo, Wo, Wo, Wo^Xo, Wo, Wo, Wo, Wo, Wo, Wo, Wo, Wo, Wo, Wo, Wo, Wo, Wo, Wo, Wo, Wo, Wo, Wo, Wo, Wo, Wo, Wo, Wo, Wo, Ww, Ww, Hh^Fds, Hh^Fds, Hh^Fds, Hh^Emf, Hh, Gd, Gs, Gg, Rb, Qxu, Uue^Vh, Qxu, Gd^Tf, Hh^Tf, Gg^Tf, Ww, Hh, Wog, Ww, Gs, Mm, Hh, Hh, Hh, Hh, Hh
Gll^Fdw, Gll^Fdw, Gll^Fmw, Gll^Fdw, Gll^Fmw, Gll^Fdw, Hhd, Gll^Fdw, Rb, Rb, Gll^Fdw, Gll^Fdw, Rb, Gll^Fdw, Ss, Ss, Ss, Ww, Wo, Wo, Wo, Wo, Wo, Wo, Wo, Wo^Xo, Wo^Xo, Wo, Wo, Wo, Wo, Wo, Wo, Wo, Wo, Wo, Wo, Wo, Wo, Wo, Wo, Wo, Wo, Wo, Wo, Wo, Wo, Wo, Wo, Ww, Ww, Hh^Fds, Hh^Fds, Hh^Fds, Hh^Fds, Hh^Fds, Gs^Fds, Gd, Gs^Fds, Rp, Rp, Uue^Emf, Gs, Qxu, Hh^Tf, Hh^Tf, Ww, Wog, Ww, Ww, Ww, Mm, Mm, Hh, Hh^Edt, Hh, Hh
Gll^Fdw, Rb, Gll^Fdw, Gll^Fdw, Gll^Fdw, Gll^Fdw, Gll^Fmw, Gll^Fdw, Gll^Fdw, Ss, Gll^Fdw, Gll^Fdw, Gs^Efm, Ss, Ss, Ss, Gs^Es, Ww, Ww, Ww, Ww, Wo, Wo, Wo, Wo, Wo, Wo, Wo^Xo, Wo^Xo, Wo, Wo, Wo, Wo, Wo, Wo, Wo, Wo, Wo, Wo, Wo, Wo, Wo, Wo, Wo, Wo, Wo, Wo, Wo, Wo, Wo, Ww, Ww, Gs^Fds, Hh^Fds, Gs^Fds, Hh^Fds, Gs^Fds, Gs^Fds, Gs^Fds, Gs^Fds, Qxu, Rp, Hh, Hh^Tf, Hh, Hh^Tf, Ww, Wog, Chw, Ww, Gg^Efm, Gs^Efm, Mm, Gs, Hh, Hh^Vhh, Rp
Gll^Fdw, Sm, Hhd, Hhd, Hhd, Ss, Hhd, Gll^Fet, Gs^Fds, Gll^Fdw, Gs^Fds, Gs, Gs, Gs, Ss, Gs, Gs, Gs, Ds, Ww, Ds, Ww, Ww, Ww, Ww, Ww, Ww, Wo, Wo, Wo^Xo, Wo^Xo, Wo, Wo, Wo, Wo, Wo, Wo, Wo, Wo, Wo, Wo, Wo, Wo, Wo, Wo, Wo, Wo, Wo, Wo, Wo, Wo, Ww, Wo, Ww, Ww, Ww, Ww, Gs^Fds, Qxu, Qxu, Kte, Re, Hh, Hh, Hh, Hh^Vhh, Ww, Wog, Ww^Bsb|, Gg, Gg^Es, Gg, Hh, Hh, Rp, Rp, Ww
Gll^Fdw, Gll^Fdw, Gll^Fmw, Gll^Fdw, Gll^Fmw, Gll^Fmw, Hhd, Gs^Fds, Hhd^Fds, Gs^Fds, Gs^Fds, Gs^Fds, Gs^Fds, Gs, Ss, Ss, Gs, Gs, Gs, Ds, Gs^Efm, Gs^Efm, Gs, Gs, Re, Re, Ch, Ww, Ww, Wo, Wo, Wo^Xo, Wo^Xo, Wo, Wo, Wo, Wo, Wo, Wo, Wo, Wo, Wo, Wo, Wo, Wo, Wo, Wo, Wo, Wo, Wo, Wo, Wo, Wo, Wo, Wo, Ww, Wo, Ww, Wwr, Qxu, Rp, Re, Rp, Hh^Emf, Rp, Gg^Dr, Ww, Wog, Khw, Ww, Gg, Hh, Hh, Hh^Edb, Rp, Ww, Ww
Gll^Fdw, Rb, Sm, Gll^Fmw, Gs, Gll^Fmw, Gll^Fdw, Hhd^Fds, Gs^Fds, Hhd^Fds, Gs^Fds, Gs^Fds, Ss, Ss, Ss, Gs, Gs, Gs^Es, Gs, Gs, Re, Re, Re, Gs^Vh, Re, Gd, Kh, Ch, Re, Ww, Wo, Wo, Wo, Wo^Xo, Wo, Wo, Wo, Wo, Wo, Wo, Wo, Wo, Wo, Wo, Wo, Wo, Wo, Wo, Wo, Wo, Wo, Wo, Wo, Wo, Wo, Wo, Wo, Wo, Ww, Ww, Ww, Ww, Ww, Rp, Rp, Re, Rp, Ww^Bsb/, Wo, Ww^Bsb\, Rp, Rb, Wo, Rp, Ww, Ww, Wo
Sm, Sm, Gll^Fmw, Gll^Fmw, Gll^Fdf, Gll^Fdw, Gll^Fdw, Gll^Fdw, Hhd, Hhd^Fds, Hh^Fds, Hh^Fds, Gs, Ss, Re^Gvs, Re^Gvs, Re^Gvs, Gs^Fet, Gs, Gs^Vh, Re, Gs^Vh, Gs, Re, Re, Ch, Ch, Ch, Gd, Ww, Wo, Wo, Wo, Wo^Xo, Wo, Wo, Wo, Wo, Wo, Wo, Wo, Wo, Wo, Wo, Wo, Wo, Wo, Wo, Wo, Wo, Wo, Wo, Wo, Wo, Wo, Wo, Wo, Wo, Wo, Ww, Ww, Ww, Ww, Ww, Ww, Ww, Ww, Ww, Wo, Ww, Ww, Rp, Wwr, Ww, Ww, Ww, Wo
Rb, Rb, Gll^Fmw, Gll^Fmw, Sm, Rb, Gll^Fmw, Gll^Fdw, Hh, Hh^Fds, Hh, Hh^Fds, Gs, Gs, Gs^Fds, Re^Gvs, Gs, Gs, Re, Re, Gs^Wm, Gs, Gs, Gs, Rrc, Rrc, Gd, Rrc, Rrc, Ww, Wo, Wo, Wo, Wo^Xo, Wo, Wo, Wo, Wo, Wo, Wo, Wo, Wo, Wo, Wo, Wo, Wo, Wo, Wo, Wo, Wo, Wo, Wo, Wo, Wo, Wo, Wo, Wo, Wo, Wo, Wo, Wo, Wo, Wo, Wo, Wo, Ww, Wo, Wo, Wo, Ww, Ww, Ww, Ww, Wo, Wo, Wo, Wo
Sm, Sm, Sm, Sm, Gs, Gll^Fmw, Gd, Hh, Hh, Hh, Gd, Gs, Gs, Gs^Fds, Gs^Fds, Gs^Fds, Gs, Gs, Gd^Vh, Re, Rrc, Rrc, Rrc, Rrc, Gd, Gd, Gd, Ds^Ewsh, Ww, Ww, Wo, Wo, Wo, Wo^Xo, Wo, Wo, Wo, Wo, Wo, Wo, Wo, Wo, Wo, Wo, Wo, Wo, Wo, Wo, Wo, Wo, Wo, Wo, Wo, Wo, Wo, Wo, Wo, Wo, Wo, Wo, Wo, Wo, Wo, Wo, Wo, Wo, Wo, Wo, Wo, Wo, Wo, Wo, Wo, Wo, Wo, Wo, Wo
Gg, Sm, Gs, Rb, Gd, Gs, Rrc, Gd, Gd, Hh, Gs, Gs, Gs, Gs, Re^Gvs, Re^Gvs, Re^Gvs, Gs, Rrc, Rrc, Gd, Gd^Vh, Gd, Gd, Gd, Gd^Es, Gd, Gd, Ww, Ww^Ewl, Ww, Wo, Wo, Wo^Xo, Wo, Wo, Wo, Wo, Wo, Wo, Wo, Wo, Wo, Wo, Wo, Wo, Wo, Wo, Wo, Wo, Wo, Wo, Wo, Wo, Wo, Wo, Wo, Wo, Wo, Wo, Wo, Wo, Wo, Wo, Wo, Wo, Wo, Wo, Wo, Wo, Wo, Wo, Wo, Wo, Wo, Wo, Wo
Rrc, Gs, Rrc, Gs, Rrc, Rrc, Gs^Fds, Rrc, Rrc, Rrc, Rrc, Rrc, Rrc, Re^Gvs, Re^Gvs, Re^Gvs, Rrc, Rrc, Gd, Gd, Gd, Gd, Gd, Gd, Gd, Gd, Gd, Gd, Gd, Ww, Ww, Wo, Wo, Wo^Xo, Wo, Wo, Ww, Wo, Ww, Wo, Ww, Wo, Wo, Wo, Wo, Wo, Wo, Wo, Wo, Wo, Wo, Wo, Wo, Wo, Wo, Wo, Wo, Wo, Wo, Wo, Wo, Wo, Wo, Wo, Wo, Wo, Wo, Wo, Wo, Wo, Wo, Wo, Wo, Wo, Wo, Wo, Wo
Gg, Rrc, Gd, Rrc, Gs^Fds, Gs^Fds, Gs, Gs, Gs, Gs^Fds, Gs^Fds, Gs^Fds, Gd^Fds, Rrc, Rrc, Rrc, Gd, Gd, Gd, Gd, Gd, Gd, Gd, Gd, Gd, Gd, Gd, Gd, Gd, Gd, Gs, Ww, Wo, Wo^Xo, Wo, Ww, Gs, Ww, Gs, Ww, Ww, Ww, Wo, Wo, Wo, Wo, Wo, Wo, Wo, Wo, Wo, Wo, Wo, Wo, Wo, Wo, Wo, Wo, Wo, Wo, Wo, Wo, Wo, Wo, Wo, Wo, Wo, Wo, Wo, Wo, Wo, Wo, Wo, Wo, Wo, Wo, Wo
