Gs, Gs, Gs, Gs, Gs, Gs, Gs, Gs, Gs, Gs, Gs, Gs, Gg, Gg, Gg, Rr, Gg, Gg, Gg, Gg, Gg, Gg, Gg, Gg, Gg, Gg, Gg^Efm, Gg, Gg, Gg, Gg, Gg, Gg, Gg, Gg, Gg, Gg
Gs, Gs, Gs, Gs, Gs, Gs, Gs, Gs, Gs, Gs, Gs, Gs, Gg, Gg, Gg, Rr, Gg, Gg, Gg, Gg, Gg, Gg, Gg, Gg, Gg, Gg, Gg^Efm, Gg, Gg, Gg, Gg, Gg, Gg, Gg, Gg, Gg, Gg
Gs, Gs, Re^Vct, Gs, Ce, Gs, Gs, Gs, Gs, Gs, Gs, Gs, Gg, Gg^Vh, Gg, Rr, Rr, Gg, Gg, Gg, Gg^Vh, Gg, Gg, Gg, Gg, Gg, Gg, Gg, Gg, Gg, Gg, Gg, Ce, Gg^Efm, Ce, Gg^Efm, Gg
Gs, Gs, Ce, Ce, Re^Vct, Ce, Gs, Gs^Fds, Gs^Fds, Gs^Fds, Gs, Gs, Re^Gvs, Gg, Gg, Gg, Rr, Gg, Re^Gvs, Gg, Gg, Gg, Gg, Gg, Gg, Gg, Gg, Gg, Gg, Gg^Efm, Gg, Gg, Gg^Efm, 3 Ke, Gg^Efm, Gg, Gg
Gs, Gs, Gs, 1 Ke, Ce, Ce, Re^Vct, Gs^Fds, Gs^Fds, Gs, Gs, Re^Gvs, Re^Gvs, Re^Gvs, Gg, Gg, Rr, Gg, Gg, Re^Gvs, Re, Gg, Gg, Gg, Gg, Gg, Gg, Gg, Gg, Gg, Gg, Gg, Gg, Gg, Gg, Gg, Rr
Rr, Rr, Rr, Gs, Gs, Ce, Ce, Gs^Fds, Gs^Fds, Gs, Gg, Gg, Gg, Gg, Gg, Gg, Rr, Gg, Re^Vct, Gg, Gg, Gg, Gg, Gg, Gg, Gg, Gg^Vh, Gg, Gg, Gg, Gg, Gg^Efm, Gg, Gg, Rr, Rr, Gg
Gs, Gs, Gs, Rr, Rr, Re^Vct, Gs, Gs, Gs, Gs, Gg, Gg, Gg, Gg, Gg, Gg, Rr, Gg, Ch, Ce, Gg, Gg, Gg, Re^Gvs, Re^Gvs, Gg, Gg, Gg, Gg, Gg, Gg, Gg, Rr, Rr, Gg, Gg, Gg^Efm
Gs, Gs, Gs, Gs, Gs, Rr, Rr, Gs, Gg, Gs, Re^Gvs, Re^Gvs, Re^Gvs, Gg, Gg, Gg, Rr, Ch, 2 Kh, Ch, Ce, Re^Vct, Re^Gvs, Gg, Gg, Re^Gvs, Re^Gvs, Gg, Gg, Gg^Efm, Rr, Rr, Gg, Gg, Gg, Gg, Gg
Gs, Gs, Gs, Gs, Gg, Gg, Gg, Rr, Rr, Gg, Gg, Re^Gvs, Gg, Gg, Gg, Gs, Rr, Ch, Ch, Ch, Gg, Re^Gvs, Re^Gvs, Re^Gvs, Re^Gvs, Gg, Gg, Gg, Rr, Rr, Gg, Gg, Gg, Gg, Gg^Efm, Gg, Gg
Gs, Gs, Gs, Gs, Gg, Gs, Gg, Gg, Gg^Vh, Rr, Rr, Gg, Gg, Gg, Gs, Rr^Vhc, Rr, Gg, Gs, Gg, Gg, Gg, Gg, Re^Gvs, Gg, Gg, Rr, Rr, Gg, Gg, Re^Gvs, Gg, Gg, Gg, Gg, Gg, Gg^Efm
Gs^Fds, Gs^Fds, Gs, Gg, Gg, Gg, Gg, Gg, Gg, Gg, Rrc, Gg, Rr^Vhc, Gs, Rrc, Rrc, Ww^Bsb|, Rrc, Rrc, Rr^Vhc, Gg, Gs, Gg, Gg, Rr, Rr, Gg, Gg, Re^Gvs, Re^Gvs, Re^Gvs, Re^Gvs, Gg, Gg, Re^Gvs, Gg, Gg
Gs^Fds, Gs^Fds, Gs^Fds, Gs, Gg, Gg, Gg, Gg, Re^Gvs, Gg, Rr^Vhc, Rrc, Rrc, Rrc, Ww, Ww, Rr, Ww, Ww, Rrc, Rrc, Gs, Rr, Rr, Gg, Gg, Re^Gvs, Gg, Gg, Re^Gvs, Gg, Gg, Gg, Re^Gvs, Re^Gvs, Re^Gvs, Gg
Gs^Fds, Gs^Fds, Gs^Fds, Gs, Gs, Gg, Gg, Re^Gvs, Re^Gvs, Re^Gvs, Gs, Rrc, Ww, Ww^Bsb\, Rr, Rr, Gg^Efm, Rr^Vhc, Rr, Ww, Ww^Bsb/, Rrc, Gs, Gg, Re, Re^Gvs, Gg, Gg, Gg^Vh, Gg, Re^Gvs, Re^Gvs, Re^Gvs, Gg, Gg, Gg, Gg
Gs^Fds, Gs^Fds, Gs, Gs, Gg, Gs, Gg, Gg, Gg, Gs, Rr^Vhc, Rrc, Ww, Rr^Vhc, Gg^Efm, Gg^Efm, Ch, Gg^Efm, Gg^Efm, Rr, Ww, Rrc, Rr^Vhc, Gg, Gg, Gg, Re^Gvs, Gg, Gg, Gg, Re^Gvs, Re^Gvs, Gg, Gg, Re, Gg, Gg
Gs, Gs, Gs, Gs, Gg, Gg, Gg, Gg, Gs, Gg, Rr^Vhc, Rrc, Ww, Rr, Rr^Vhc, Ch, 5 Kh, Ch, Rr, Rr^Vhc, Ww, Rrc, Gs, Gs, Gg, Re^Gvs, Re^Gvs, Re^Gvs, Re^Gvs, Gg, Gg, Gg, Gg, Re, Re, Re, Gg
Gs, Gs, Gg, Gg, Ch, Ch, Ch, Gg, Gs, Gg, Gs, Rrc, Ww, Ww, Rr, Ch, Ch, Ch, Rr, Ww, Ww, Rrc, Rr^Vhc, Gs, Gs, Gg, Gg, Re^Gvs, Gg, Gg, Gs, Gg, Gs, Gg, Gg, Gg, Gg
Gs, Gs, Gg, Gg, Ch, 6 Kh, Ch, Gg, Gg, Gg, Rr^Vhc, Rrc, Ww^Bsb/, Ww^Bsb/, Ww, Rr, Gg^Efm, Rr, Ww, Ww^Bsb\, Ww^Bsb\, Rrc, Gs, Gg, Gg, Gg, Gs, Gg, Ch, Gg, Gs, Gs, Gg, Gg^Vh, Gg, Gg, Gg
Gg, Gg, Gs, Gg, Gs, Ch, Rr, Gg, Gg, Gs, Rr, Rrc, Rr, Ww, Ww, Rr^Vhc, Rr, Rr^Vhc, Ww, Ww, Ww, Rrc, Rr, Gs, Gs, Gs, Gg, Ch, 7 Kh, Ch, Gs, Gg, Ww, Ww, Ww, Ww, Ww
Gg, Gg, Gg, Gs, Gs, Gg, Gg, Rr, Rr, Rrc, Gg, Rr^Vhc, Gs, Rr^Vhc, Rrc, Ww, Ww^Bsb|, Ww, Rrc, Rr^Vhc, Ww, Rr^Vhc, Ww, Rr, Rr, Gs, Rr, Ch, Ch, Ch, Ww, Ww, Ww, Ww, Ww, Ww, Ww
Gg, Gg, Gs, Gs, Gg, Gg, Rr, Rr, Gg, Gg, Gg, Gs, Gs, Gs, Rr^Vhc, Rrc, Rrc, Rrc, Rr, Gg, Gg, Ww, Ww, Ww, Ww, Rr, Ww^Bsb\, Ww, Ww, Ww, Ww, Ww, Ww, Ww, Ww, Ww, Ww
Gg, Gg, Gg, Gg, Rr, Rr, Gg^Vh, Gg, Gg, Gg, Gg, Gg, Gg, Gs, Gg, Gg, Gg, Gg, Gg, Rr, Ww, Ww, Ww, Ww, Ww, Ww, Ww, Ww^Bsb\, Ww^Bsb\, Ww, Ww, Ww, Gg, Ww, Gg, Gg, Gg
Gg, Gg, Rr, Rr, Gg, Gg, Gg, Gg, Gg, Gg, Gg, Gg, Gg, Gg, Ww, Ww, Ww, Ww, Ww, Ww^Bsb|, Ww, Ww, Ww, Ww, Hh, Ww, Ww, Ww, Gg^Vhc, Rr, Rr, Gg, Gg, Gg, Gg, Gg, Gs^Fds
Rr, Rr, Gg, Gg, Gg, Gg, Gg, Gg, Gg, Gg, Ww, Ww, Ww, Ww, Ww, Ww, Ww, Ww, Ww, Ww^Bsb|, Ww, Ww, Ww, Hh, Hh, Hh, Hh, Hh, Hh, Gg, Re^Gvs, Rr, Rr, Gg, Rr, Gg, Gg
Gg, Gg, Gg, Gg, Gg, Gg, Ww, Ww, Ww, Ww, Ww, Ww, Ww, Ww, Ww, Ww, Ww, Ww, Gg, Rr, Gg, Gg, Gg, Gg, Gg, Hh, Hh, Hh, Hh, Re^Gvs, Re^Gvs, Re^Gvs, Gg, Rr, Gg, Rr, Rr
Gg, Gg, Ww, Ww, Ww, Ww, Ww, Ww, Ww, Ww, Ww, Ww, Ww, Ww, Gg, Gg, Gg, Gg, Gg, Rr, Gg, Gg, Gg, Gg, Re^Gvs, Hh, Re^Gvs, Hh, Hh, Hh, Gg, Gg, Gg, Gg, Gg, Gg, Gg
Ww, Ww, Ww, Ww, Ww, Ww, Ww, Ww, Ww, Ww, Ww, Ww, Gg, Gg, Gg, Gg, Gg, Gg, Gg, Rr, Rr, Gg, Re^Gvs, Re^Gvs, Re^Gvs, Re^Gvs, Re^Gvs, Re^Gvs, Re^Gvs, Hh, Hh, Gg, Gg, Gg, Gg, Gg, Gg
Ww, Ww, Ww, Ww, Ww, Ww, Ww, Ww, Ww, Ww, Gg, Gg, Gg, Gg, Gg, Gg, Gg, Gg, Gg, Rr, Rr, Gg, Gg, Re^Gvs, Re^Gvs, Re^Gvs, Re^Gvs, Re^Gvs, Gg, Hh, Hh, Gg, Gg, Gg, Gg, Gg, Gg
Ww, Ww, Ww, Ww, Ww, Ww, Gg, Gg, Gg, Re^Vct, Gg, Gg, Gg, Re^Vct, Gg, Gg, Gg, Gg, Gg, Gg, Rr, Gg, Gg, Gg, Gg, Gg, Gg, Gg, Gg, Hh, Hh, Gg, Hh, Hh, Hh, Gg, Gg
Ww, Ww, Ww, Ww, Gg, Gg, Gg, Re^Vct, Ce, Gg, Ce, Re^Vct, Ce, Gg, Ce, Re^Vct, Gg, Gg, Gg, Gg, Rr, Gg, Gg, Gg, Gg, Gg, Gg, Gg, Gg, Gg, Hh, Hh, Hh, Hh, Hh, Hh, Gg
Ww, Ww, Ww, Gg, Gg, Gg, Gg, Ce, Ce, Ce, Ce, Gg, Ce, Ce, Ce, Ce, Gg, Gg, Gg, Gg, Rr, Gg, Gg, Gg, Gg, Gg, Gg, Gg, Gg, Gg, Gg, Hh, Hh, Hh, Gg, Hh, Gg
Ww, Ww, Gg, Gg, Gg, Re^Vct, Gg, Gg, Gg, Gg, Gg, 4 Ke, Gg, Gg, Gg, Gg, Gg, Re^Vct, Gg, Gg, Gg, Rr, Gg, Gg, Gg, Gg, Gg, Gg, Gg, Gg, Gg, Gg, Gg, Gg, Gg, Gg, Gg
Gg, Gg, Gg, Gg, Gg, Gg, Gg, Gg, Gg, Gg, Gg, Gg, Gg, Gg, Gg, Gg, Gg, Gg, Gg, Gg, Gg, Rr, Gg, Gg, Gg, Gg, Gg, Gg, Gg, Gg, Gg, Gg, Gg, Gg, Gg, Gg, Gg
