|0000000000000000000000000000000000000000
|0000000000000000000000000000000000000000
|0000000000000000000000000000000000000000
|0000000000000000000000000000000000000000
|0000000000000000000000000000000000000000
|0000000000000000000000000000000000000000
|0000000000000000000000000000000000000000
|0000000000000000000000000000000000000000
|0000000000000000000000000000000000000000
|0000000000000000000000000000000000000000
|0000000000000000000000000000000000000000
|0000000000000000000000000000000000000000
|0000000000000000000000000000000000000000
|0000000000000000000000000000000000000000
|0000000000000000000000000000000000000000
|0000000000000000000000000000000000000000
|0000000000000000000000000000000000000000
|0000000000000000000000000000000000000000
|0000000000000000000000000000000000000000
|0000000000000000000000000000000000000000
|0000011100000000000000000000000000000000
|0000011110000000000000000000000000000000
|0001111111000000000000000000000000000000
|0001111111100000000000000000000000000000
|0011111111000001110000000000000000000000
|0111111111100011111000000000000000000000
|1111111111101111111111000000000000000000
|1111111111101111111111100000000000000000
|1111111111111111111111000000000000000000
|1111111111111111111111110000000000000000
|1111111111111111111111110000000000000000
|1111111111111111111111111000000000000000
|1111111111111111111111110000000000000000
|1111111111111111111111111000000000000000
|1111111111111111111111110000000000000000
|1111111111111111111111111000000000000000
|1111111111111111111111111000000000000000
|1111111111111111111111111100000000000000
|1111111111111111111111111111000000000000
|1111111111111111111111111111100000000000
|1111111111111111111111111111100000000000
|1111111111111111111111111111100000000000
|1111111111111111111111111111100000000000
|1111111111111111111111111111100000000000
|1111111111111111111111111111100000000000
|1111111111111111111111111111100000000000
|1111111111111111111111111111100000000000
|1111111111111111111111111111110000000000
|1111111111111111111111111111110000000000
|1111111111111111111111111111111110000000
|1111111111111111111111111111111110000000
|1111111111111111111111111111111110000000
|1111111111111111111111111111111110000000
|1111111111111111111111111111111110000000
|1111111111111111111111111111111110000000
|1111111111111111111111111111111111000000
|1111111111111111111111111111111111000000
|1111111111111111111111111111111111110000
|1111111111111111111111111111111111110000
|1111111111111111111111111111111111111000
|1111111111111111111111111111111111111000
|1111111111111111111111111111111111111100
|1111111111111111111111111111111111111000
|1111111111111111111111111111111111111000
|1111111111111111111111111111111111110000
|1111111111111111111111111111111111111000
|1111111111111111111111111111111111110000
|1111111111111111111111111111111111111000
|1111111111111111111111111111111111111000
|1111111111111111111111111111111111111100
|1111111111111111111111111111111111111100
|1111111111111111111111111111111111111100
|1111111111111111111111111111111111111000
|1111111111111111111111111111111111111100
|1111111111111111111111111111111111111000
|1111111111111111111111111111111111110000
|1111111111111111111111111111111111100000
