|11111111110000000000000111111
|11111111111000000000000011111
|11111111111000000000000011111
|11111111111110000000000011111
|11111111111111000000000111111
|11111111111111100000000111111
|11111111111111100000000111111
|11111111111111111000000011111
|11111111111111111000000011111
|11111111111111111000000001111
|11111111111111111000000000000
|11111111111111111000000000000
|11111111111111110000000000000
|11111111111111111000000000000
|11111111111111111000000000000
|11111111111111111100000000000
|11111111111111111100000000000
|11111111111111111110000000000
|11111111111111111110000000000
|11111111111111111110000000000
|11111111111111111110000000000
|11111111111111111110000000000
|11111111111111111110000000000
|11111111111111111111000000000
|11111111111111111110000000000
|11111111111111111110000000000
|11111111111111111100000000000
|11111111111111111100000000000
|11111111111111111000000000000
|11111111111111111100000000000
|11111111111111111000000000000
|11111111111111111000000000000
|11111111111111111000000000000
|11111111111111111100000000000
|11111111111111111000000000000
|11111111111111111100000000000
|11111111111111111100000000000
|11111111111111111110000000000
|11111111111111111110000000000
|11111111111111111111000000000
|11111111111111111111100000000
|11111111111111111111100000000
|11111111111111111111000000000
|11111111111111111111100000000
|11111111111111111111100000000
|11111111111111111111110000000
|11111111111111111111110000000
|11111111111111111111111000000
|11111111111111111111111100000
|11111111111111111111111111100
|11111111111111111111111111100